RT @KooL1015Calgary: .@nenshi let's make Canada Day the 1st day citizens return to downtown #yycflood - What a Great Idea!!!	Not applicable
RT @winecountrydog: #COflood #HORSES - Colorado HorseCare Foodbank / horse hay bank URL	Affected individuals
RT @emikatj: If you volunteer, take: mask, HEADLAMP, rubber gloves/boots, bug spray, sunscreen. Also buckets. #yychelps #yycflood	Donations and volunteering
RT @SteveGrzanich Emergency Management in Colorado reports 584 people now unaccounted for after flooding. via @denverpost #BoulderFlood	Affected individuals
I'll show the doppler radar from Boulder Colorado in just a minute...major flooding...and bridge washed away.  Amazing live pictures.	Other Useful Information
Baby stuffed in bag, hoisted from flood: Australia's powerful storms led to an amazing rescue of two women and a... URL	Affected individuals
RT @MarciKrivonen: Wow. RT @HemaMullur: Two trucks, one car submerged after road collapse at Hwy 287 and Dillon. #cowx #boulderflood URL	Infrastructure and utilities
RT @yychelps: CBC Calgary: Alberta unveils new flood proofing rules.... URL	Other Useful Information
COLORADO FLOODS - CALIFORNIA FIRES ?	Other Useful Information
RT @EpochTimes: Canmore Flood Could Force 100,000 From Homes in Canada URL | Epoch Times	Affected individuals
@Premier_Redford @nenshi @TeamWildrose wildURL #abflood #beautiful song	Other Useful Information
Finally have power! #qldfloods #bigwet	Infrastructure and utilities
RT @JoelOlandesca: The Morley reserve has NO drinking water. Please send bottled water their way if you can! #yycflood #yychelps #abfloods	Donations and volunteering
RT @ReidFiest: Driving in Kensington. All the power is off. Weird scene. No flooding yet. #yycflood URL	Other Useful Information
RT @ShonnaTheWhite: This is why we need the Stampede this year. Non-profits will be struggling with donations after the flood. #yycflood ht‚Ä¶	Donations and volunteering
RT @qpsmedia: New England Highway from Warwick - Toowoomba not yet open. Road still needs inspection. #bigwet	Caution and advice
it sucks that the floods in Colorado are affecting Riot Fest but even still my heart goes out to those in Colorado and being affected	Sympathy and support
@AndrewLamingMP's poll on FB is asking whether we would support 'another Labor flood levy' after #bigwet #auspol‚Äù because they hate QLDers	Other Useful Information
RT @CstShaw: Things like this are what keep us going during our 79th hour of work this week. Thank you! #yycflood #yyc URL	Sympathy and support
Apparently Wollongong is going to cop this Qld rain and floods about midnight Monday? Anyone know anything more?	Other Useful Information
Pray for Boulder, Colorado #boulderflood	Sympathy and support
Looking to interview people with exceptional stories of the #yycflood, be you victims, volunteers, officials... Contact me. @nenshi pls RT	Other Useful Information
RT @RedCrossDenver: #COFloodRelief fundraiser full number is 1-877-667-6727 after 4 PM MT	Donations and volunteering
Want to help #COFlood victims? Here's how: URL	Donations and volunteering
Donations to Queensland flood appeal fall short of expectations : URL	Donations and volunteering
RT @NHLFlames: Flooding goes to row 8 in the Scotiabank Saddledome #yycflood #yyc URL	Infrastructure and utilities
30/09:03 EST Flood Warning - Condamine-Balonne Rivers (QLD)  URL	Caution and advice
We have officially lost power in #palmwoods #bigwet	Infrastructure and utilities
RT @chuckwoolery: Reid Blames Colorado Floods On 'Climate Change' URL via @BreitbartNews PASSED LOBOTOMY	Other Useful Information
Colorado..... We feel your pain ‚òîÔ∏è‚òîÔ∏è‚òîÔ∏è‚òîÔ∏è‚òîÔ∏è‚òîÔ∏è‚òîÔ∏è‚òîÔ∏è‚òîÔ∏è‚òîÔ∏è‚òîÔ∏è‚òîÔ∏è‚òîÔ∏è‚òîÔ∏è‚òîÔ∏è‚òîÔ∏è‚òîÔ∏è‚òîÔ∏è‚òîÔ∏è‚òîÔ∏è‚òîÔ∏è‚òîÔ∏è‚òîÔ∏è‚òîÔ∏è‚òîÔ∏è‚òîÔ∏è‚òîÔ∏è‚òîÔ∏è‚òîÔ∏è‚òîÔ∏è #flooding #rain	Sympathy and support
Flood waters head for the cotton fields: It's a wait and see game for cotton growers on the Queensland-NS... URL #water	Affected individuals
RT @coloradoan: Shutdown could slow flood recovery.  URL #COFlood	Other Useful Information
RT @weblaur: prayers to those involved in the shooting in D.C. and to all the families dealing with the floods in Colorado :/	Sympathy and support
RT @SummersAnne: QLD premier Campbell Newman I'm determined to ensure that this flooding won't be similar to the flooding of 2011. Kin ...	Other Useful Information
Calgary June 21 2013 #yycflood #Calgary Deerfoot Trail by Inglewood Golf course URL	Infrastructure and utilities
RT @CherylPreheim: NEW: Sewage has leaked into water in some areas.  Stay away from water per Boulder Sheriff Dept. @9NEWS #coflood	Caution and advice
#pakistan#news Military called in as deadly floods batter Australia: BRISBANE: Australia ramped up its military ... URL	Affected individuals
RT @bencubby: Between 80 and 150mms of rain expected in Sydney overnight, with winds up to 90km/h. URL #bigwet	Other Useful Information
RT @CalgaryPolice: List of current road closures #yycflood #yyc URL	Infrastructure and utilities
RT @GaltsGirl: The Red Cross arrived.... #COFlood¬†URL	Donations and volunteering
Update. We have two road crashes, Peachester Road, QFRS responding Horsecamp Road Swiftwater incident #bigwet	Affected individuals
Hand of Hope Works to Help Victims of Calgary Flood  #MissionMonday URL	Donations and volunteering
New warnings #abflood victims about price gouging and fake charities. @cgoomansingh reports: URL	Caution and advice
Some neighbourhoods to re-open in #Calgary as flooding situation improves #ABflood #YYC  URL	Caution and advice
Thouthands of people evacuated in #Australia due to floods, two deaths :/	Affected individuals
Floods Transform Colorado's 'Gore-Tex Vortex'	Infrastructure and utilities
Another #CoFlood today #ugh #omg I wish this #weather get nice tomorrow	Sympathy and support
Colorado flooding turns deadly URL	Affected individuals
Pics from Laidley clean-up. Still a long way to go till the community gets back to normal URL #bigwet #qldfloods	Affected individuals
RT @Mamamia: If you would like to donate to the Red Cross QLD Floods Appeal, to help families and communities, consider calling 1800 811 ...	Donations and volunteering
RT @breakingstorm: 5 people confirmed dead in Colorado flooding, and 1,254 people unaccounted for statewide, official says - @NBCNews URL	Affected individuals
RT @meltzere: 'Weeks, months, years to recover' Every #Boulder department head using this phrase. #boulderflood	Other Useful Information
RT @QPSmedia: The Bruce Highway has now been closed at 12 Mile Creek, Raglan. #bigwet #qldtraffic	Infrastructure and utilities
@NASALADEE I heard LDEX came on after a brief delay due to the flooding in Colorado (LDEX's home institution). Way to go guys!	Other Useful Information
RT @LisaVanderpump: Australia...sorry to hear of the extreme flooding,several lives lost already...	Sympathy and support
Many Missing Now Accounted For In Colorado Flooding URL	Affected individuals
The Colorado Office of Emergency Management estimates nearly 19,000 homes are damaged or destroyed. #coloradoflood	Infrastructure and utilities
RT @otiose94: ‚Äú@stuartcmcgill: Qld surprised flood peak in Bundaberg will be higher than 2011. Join the dots!‚Äù #climatechange #auspol	Other Useful Information
RT @bpincott: @aldjohnmar &amp; I helping to evacuate 125 people from @innfromthecold. No heat, water or power  #yycflood URL	Donations and volunteering
Money Mentors Reaffirms Its Services and Advises Alberta Flood Victims. URL #ab #finlit	Caution and advice
Queensland flood emergency - ABC Online URL #Brisbane #News	Other Useful Information
RT @Clemson_CR: No matter the differences when Americans truly need help, we all come together. #PrayersforDC #Coloradoflood	Sympathy and support
Just saw a c-117 on approach for yyc. CAF #yycflood	Affected individuals
RT @TPM: PHOTO: Extreme flooding in Canada may force 100,000 from homes today. This man swims after his cat: URL	Affected individuals
RT @WaterPortal: RT @berkleyroth A dirt berm on the Elbow River broke in the Mission neighborhood of Calgary, flooding the Safeway.  #yyc #‚Ä¶	Infrastructure and utilities
RT @winecountrydog: HAY Coloradoans! #COflood #HORSES - contact Colorado Horse Care Foodbank 4 help. URL #COfloods #equi‚Ä¶	Donations and volunteering
Thoughts and prayers with my #boulderflood affected friends and family. Please stay safe!	Sympathy and support
RT @MadelineNovey: 40 people rescued from Big Thompson Canyon via ATV #coflood URL	Affected individuals
RT @WestJet: Brett Wilson's garden party! Retweet with #OMGP hashtag &amp; @WBrettWilson gives $1 to the #abflood recovery. URL	Donations and volunteering
PHOTOS: Unreal Aerial Views of Devastation from Colorado Flooding URL	Other Useful Information
RT @calgarysun: Mayor of High River asks province to take over recovery and rebuilding efforts #abflood	Infrastructure and utilities
RT @AthabascaU: To AU students who've been affected by the flood in southern Alberta:  For those of you scheduled to write exams... URL	Infrastructure and utilities
Alberta Flood: Rogers Donates $100K to Red Cross; Google Creates Crisis Maps URL	Donations and volunteering
23/16:03 EST Flood Warning - Coastal Rivers - North (QLD) URL #BIGWET #QLD UPDATED ITEM URL	Caution and advice
DESPITE FLOODS, CRUEL BARBARIC Calgary Stampede is Back, WHEN will this END? URL	Not applicable
RT @carlyraejepsen: So sad to hear about the floods in Calgary and that the show was cancelled. I'll be back soon! Stay safe everyone! Xox	Sympathy and support
RT @breakingstorm: 3 dead in Colorado flooding after body of adult male discovered in Boulder County - @DenverChannel; for more: URL	Affected individuals
#Lismore Airport is now re-opened but all flights today are still diverted to Ballina #bigwet	Infrastructure and utilities
RT @larissawaters: If you have the means, please join me in donating to the Qld Floods Appeal 2013 at URL #bigwet	Donations and volunteering
RT @31stScouts: Media reports @CanadianArmy Reservists from #Edmonton staging in #RedDeer for deployment to #Canmore #Calgary ‚Äî #yycFlood #‚Ä¶	Donations and volunteering
üò≥üò±üòî RT @jonoperry: The big surf has destroyed Noosa Beach #bigwet URL	Infrastructure and utilities
Wet wet wet and getting wetter!  10 Day Rain &amp; Wind Forecast Models URL #BIGWet #SEQLD #GoldCOast URL	Other Useful Information
RT @SimonOstler: Calgary RT @CTVStephBrennan: This is Riverfront Avenue URL  #yycflood	Infrastructure and utilities
RT @ArielMata: Lefthand Canyon from Sky9. #coflood URL	Other Useful Information
URL Australian state of Queensland braces for flooding The #nbc #news #free #architecture #startup #stocks #ebay #mktg	Infrastructure and utilities
@ColdJadedWolf We're fine. The flooding in north of us,but my bf's mum is stuck in Queensland.	Affected individuals
Colorado flooding could help keep tourists away: DENVER (AP) ‚Äî Little more than a year after Colorado Gov. Joh... URL	Other Useful Information
RT @TerriClarkMusic: Stay tuned for a super cool way to donate to the victims of the Alberta flood of 2013 through URL -‚Ä¶	Donations and volunteering
RT @KYLEGARRETT: Mission is fully submerged. (Taken from Holy Cross Hospital rooftop).#YYCFlood #ABFlood #YYC URL	Infrastructure and utilities
We really have to stop and thank all of the amazing first responders in the province. @calgarypolice #yycfloods #albertafloods	Sympathy and support
The Bow from our deck! She's not happy! #yycflooding URL	Affected individuals
RT @PeterDoherty7: MAP: New Bureau of Meteorology projection for rainfall across Australia Day Long Weekend #bigwet URL	Caution and advice
RT @petsarefound: LOST Blue Burmese CAT, Glass House Mountains #QLD #qldfloods #bigwet URL via @PetsAreFound Pls RT	Affected individuals
RT @DenverChannel: Flooding at Red Rocks Amphitheatre - about 30 rows under water! Photo via URL #COwx #COflood URL	Infrastructure and utilities
RT @QPSmedia: EMERGENCY ALERT: Laidley Creek is expected to peak at 5.30pm with major flooding to 2011 levels. #bigwet	Caution and advice
RT @660News: 26 thousand people remain evacuated from their homes in the  province. #abflood	Affected individuals
Colorado Brewery On Banks Of Flooding St. Vrain River Survives With Help Of Malt B via  @huffingtonpost #smallbiz URL	Infrastructure and utilities
@globepolitics: Alberta shelved major flood report for six years URL #cdnpoli	Other Useful Information
RT @Mookalicious: This pic of an awesome firefighter in Mission needs to go viral.  Please share! #abflood URL	Donations and volunteering
Prayers going out to everyone who's getting affected by the Colorado flooding. I have a friend who is VERY close to the flooding.	Sympathy and support
RT @7NewsBrisbane: Who does EMQ turn to for the latest breaking news? #bigwet #qldfloods URL	Other Useful Information
Oil spills, floods, airlifts in Colorado: Efforts continued Friday to cope with fallout from flooding that''s ... URL	Other Useful Information
7News gives $10k to #COfloodrelief from Scripps Howard Fund. Who else is stepping up? Telethon tonight 4-10:30. URL	Donations and volunteering
Flooding in discovery ridge in calgary June 20 2013: URL via @youtube #YYC #Flood #Calgaryflood #yycflood	Infrastructure and utilities
Floods in Canada:  downtown Calgary  partially evacuated URL 15	Other Useful Information
How can we help? #Colorado towns still surrounded by water, residents using refrigerators as 'life rafts': URL #COFlood	Affected individuals
The Home Depot Canada Donates $125000 To Help Alberta Flood Victims - Wall Street Journal: The Home Depot Cana... URL	Donations and volunteering
Start to worry when my backyard start to flash flooded, but won't take long before its gone. Thanks GOD! #bigwet	Caution and advice
RT @JamesWoodHerald: Sign on CP Rail float - safety first. Not sure how that will go over. #abflood #chlive #bonnybrook	Infrastructure and utilities
RT @ArleneDickinson: This. Is. McLeod. Trail.  OMG.  #yycflood URL	Infrastructure and utilities
RT @Calgonaway: My prayers go out to all the flooding victims in Colorado right now.	Sympathy and support
RT @JeremyHubbard: Another great pic of #Boulderflood from Instagram. #Boulder @KDVR brandash's photo URL	Other Useful Information
RT @Gold_Coast_City: Latest from #goldcoast Mayor Tom Tate including new radio interview URL #bigwet #qldflood #qldfloods	Other Useful Information
City of #Boulder Emergency Declaration: URL #BoulderFlood -@CNNEditorChuck	Caution and advice
RT @metrocalgary: TD Insurance says it will cover Calgary sewer backup claims URL #yycflood	Other Useful Information
RT @abcnews: Follow our live coverage of the flood crisis in south-east Qld and northern NSW URL #qldfloods #nswfloods  ...	Other Useful Information
RT @ZackMalitz: It's hard to find words for how awful the flooding of CO's #fracking fields is: URL #coflood #boulderflo‚Ä¶	Sympathy and support
RT @MarkSCScott: Calgary flood from my balcony in Mission. Now - high. #yycflood URL	Other Useful Information
RT @QldSES: Help us update our #bigwet Google map. Send your flood and weather photos to us as a private message or tweet to... URL ...	Other Useful Information
RT @JeffALewis: Peace bridge again, looking southwest #yycflood URL	Infrastructure and utilities
RT @yuppielove: OMG! ‚Äú@aimeedodge: @EmilyMcTeer ‚Äú@KB_Dutch: #yyccc #yycflood corner of 17 and Macleod  @ 6:30 am June 21.URL	Not applicable
RT @NewsBreaker: More on deadly Colorado flooding reported by @Kelly7News with @7newsNOW.	Caution and advice
RT @GlobalEdmonton: Calgary Zoo announces animal deaths after flooding. #yycflood #ABflood URL	Affected individuals
Benevity Creates Southern Alberta Flood Relief Fund on The Need Is Now!,  An Online Giving Site for Disaster Relief URL	Donations and volunteering
RT @breakingstorm: Extremely dangerous and life threatening situation in Boulder, Colorado, area as flash flooding continues - @usNWSgov ht‚Ä¶	Other Useful Information
@PaulPabst  RT @jaymes: @MattBInYYC @alex_ruiz Not sure if either of you seem this one yet #yycflood #Flames URL	Other Useful Information
RT @QPSmedia: A heads up for boaties in SEQ if you haven‚Äôt already now is the time to check those moorings or anchors! #bigwet	Caution and advice
RT @TimesCall: Juveniles seen removing barricades from Colo. 52 and County Line Road. #notfunnyidiots #boulderflood #erie #frederick	Infrastructure and utilities
RT @TimesCall: #Longmont under state of emergency until Oct. 10. City manager can order evacuations, curfews. #longmontflood  URL	Caution and advice
RT @DenverChannel: #COFloodRelief fundraiser today! Please retweet! Details: URL URL	Donations and volunteering
RT @cu_cstpr: Colorado‚Äôs exceedingly rare flood in 3 maps URL #boulderflood #COflood	Other Useful Information
My heart goes out to my fellow Coloradans who have lost so much in the #BoulderFlood.  Praying for you all!	Sympathy and support
BHP coalmines hit by floods: BHP, Qld's biggest coal producer, is set to lose production from its Bowen Basin co... URL	Infrastructure and utilities
Five local states of emerg ended: Leth city &amp; county; Cypress County; Red Deer, Crowsnest Pass. #ABflood #yycflood #yyc #ableg #abpoli	Infrastructure and utilities
Raw Video:  Downtown Calgary flooding | Global News Video URL via @sharethis	Other Useful Information
Really grateful I haven't been hit by the floods in Australia, prayers so go out to all those affected	Sympathy and support
T'storms crossing I-25 toward #Longmont. Strong storm sitting over #Brighton tracking NE. #9wx forecast on #9News now URL	Other Useful Information
RT @DenverChannel: #BREAKING: Re-evacuation orders in Longmont - act now!! Greens, Champion Greens and the Valley neighborhood #COflood #CO‚Ä¶	Caution and advice
RT @TELUS: Big thanks to our team in #YYC who worked to fortify our network for #abflood - loads of sandbags! We will be monitoring it.	Sympathy and support
Deputy principal of Kenmore South State School has confirmed it will be shut today due to lack of power. #bigwet	Infrastructure and utilities
RT @earthskyscience: Flood waters expected to peak around noon (local time) today in Alberta, Canada.  URL	Caution and advice
RT @Juniper00: RT @SeawaBob: Cdn Forces unpack supplies &amp; materials around 12 Sunday @CHHS. #MedHat #MHFlood #AbFlood URL	Donations and volunteering
Insurance companies brace for flood of claims URL #abflood #yycflood	Other Useful Information
RT @GlobalCalgary: UPDATE: Native reserves issue urgent appeal for donations, volunteers: URL #abflood #yycflood	Donations and volunteering
Wow, I've never seen the river this high before.  #abflooding #yycflood	Affected individuals
RT @TotalTrafficDEN: #Longmont closed on Hwy 287 SB at CO-52 and CO-7 in #Boulder #COtraffic URL	Caution and advice
RT @CstShaw: Dinner time thanks to @TasteofIndiaNW at police headquarters tonight. #yycflood #yyc URL	Not applicable
RT @mandykorenowski: I am excited at the opportunity to learn how to have a 3 minute shower #ThinkPositive  #yycflood	Not applicable
RT @YahooNews: Hundreds are still missing in Colorado with more rain and flooding expected to hamper rescue efforts today: URL	Affected individuals
Haven't heard much about the homeless during #yycflood. Glad @calgarydropin is looking out for them tonight.	Affected individuals
Trees down in CBD #qldfloods URL	Infrastructure and utilities
Floods in Eastern Australia URL	Other Useful Information
RT @RACQOfficial: We‚Äôve had one of our busiest days ever with more than 4,900 roadside rescues and 3,058 insurance claims! #bigwet	Donations and volunteering
@Harry_Styles there is really bad flooding in parts of Australia :(	Other Useful Information
Stay safe, #yyc friends #abflood	Sympathy and support
RT @Suburban_mumof2: 2weeks ago it was bushfires. Today it's floods. Prayers for everyone in our big wide land #Australia	Sympathy and support
Gayndah residents must boil drinking water, use water for drinking, hygiene only: URL #qldfloods #bigwet	Caution and advice
Text REBUILD to 27722 to donate $10 to Colorado Flood Relief through Lefthand Brewing Co. URL #coflood #longmontflood	Donations and volunteering
RT @mikesbloggity: Water now flowing over the pathway to Prince's Island Park. #abflood URL	Infrastructure and utilities
NBN services affected by Qld floods - Computerworld Australia URL	Affected individuals
Residents thankful for evacuation centres URL #qldfloods	Donations and volunteering
Don‚Äôt get Pulled Under: Tips for Spotting a Flood-Damaged Car URL #COFlood #Flood #Insurance	Caution and advice
RT @reeseatomic: to all my QLD friends, PLEASE stay safe. the rest of australia will be thinking of you #bigwet @QLDfloods	Sympathy and support
RT @freekibble: 100% of the kibble raised @Freekibble today goes to homeless pets impacted by the flooding in Colorado! Spread word! URL	Donations and volunteering
Yesterday our UH-60 crews assisting w/ #coflood rescued 26 people and more than 20 animals - including a turtle! #nationalguard	Affected individuals
On the News With Thom Hartmann: More Than 1,200 People Unaccounted for in the Colorado Flooding, and More URL	Affected individuals
RT @COUNTRYMUSICRD: HELP FELLOW CANADIANS IN NEED!  2013 Alberta Flood Relief T-Shirt URL  @TerriClarkMusic	Donations and volunteering
RT @ohitseesha: yesterday in australia: fuck we are burning to the ground  today in australia: fuck we are flooding	Affected individuals
@WBrettWilson donating $1 for every tweet, RT of hashtag #OMGP to max 50k for #yycflood Spread the word.	Donations and volunteering
‚Äú@WilliamShatner: My thoughts and prayers are with the flood victims in Calgary. MBB‚Äù #yyc #yycflood	Sympathy and support
Three dead, dozens trapped in Australia floods URL	Affected individuals
RT @QLDOnline: 28/15:00 EST Flood Warning - Mary River (QLD)  URL	Caution and advice
RT @CalgaryPolice: Aerial photo of flooding at the Calgary Stampede Grandstand. #yycflood URL	Other Useful Information
RT @femaregion8: Official accts to follow for #COflood updates: @COEmergency @BoulderOEM @RedCrossDenver @LarimerSheriff @bouldercounty @je‚Ä¶	Other Useful Information
1,200 People Missing as Devastating Floods Continue in Colorado - Flood Waters Rising: Situation Worsens in... URL	Affected individuals
@anndecter @YWCACanada @YWCAofCalgary Thanks Ann. Response has been incredible.  #yycflood	Sympathy and support
RT @BrockWHarrison: . @ElectDanielle and other volunteers now stranded inside High River General Hospital until water recedes. #abflood #ab‚Ä¶	Affected individuals
This is 2013. A Christian commentator blames the floods in Colorado on....the Gays: URL  Religion, I told you !!!!	Not applicable
@nenshi LOVE the @CalgFoundation shout out on #NenshiLive @ShawTVCalgary Such a GREAT place to donate to support #yyc #yycflood #yychelps	Donations and volunteering
RT @PGATOURCanada: .@GrahamDeLaet is donating $1k per birdie &amp; $2.5k per eagle this week to #ABFlood relief. #PGATOURCanada is proud to mat‚Ä¶	Donations and volunteering
More #LockyerValley evacs. Houses flooded in 2011 in Glenore Grove and Kensington Grove asked to evac to Gatton Shire Hall #bigwet	Caution and advice
Flooded Colorado to get heavy rain: Flooding has stranded thousands, cut towns apart, ripped out roads and94jiVNUyzIuFPA7JhxeY	Infrastructure and utilities
Colorado Flooding Imperils Oil and Gas Sites, Causes Spill URL  via @NatGeo	Infrastructure and utilities
RT @UCalgary: Due to #yycflood and traffic concerns, #UCalgary has cancelled Fri's #stampede breakfast at downtown campus.	Infrastructure and utilities
RT @VolunteerCal: ITEMS NEEDED! RT@cbmyyc: @innfromthecold needs grocery store gift cards and bus passes! #yycflood	Donations and volunteering
RT @QPSmedia: Flinders Parade, Brighton. Pedestrains and cars PLEASE LEAVE THE AREA, it is unsafe and you're causing police issues! #bigwet	Caution and advice
Queensland flood victims join action against Government: -- Delivered by Feed43 service URL	Affected individuals
RT @SuperWiki: Welcome to your nightmare! MT@7NewsBrisbane: Grey Wolf Spider escorting young from floods in #Jandowae #Australia URL ...	Affected individuals
Lions, tigers, bears bask in rainwater at Colorado wildlife sanctuary - The Denver Post URL via @denverpost #coflood	Affected individuals
RT @Paulatics: A very lovely, and surprising hopeful video. For Our Tomorrow - Calgary Flood 2013: URL #yyc #abflood	Sympathy and support
RT @Frack_Off: What happens when flash floods hit open-air #fracking waste water ponds?: URL #Australia #coalbedmethane	Other Useful Information
RT @cityofcalgary: For your safety please stay away from all waterways at this time. They can be very dangerous #yycflood	Caution and advice
#COPets #COFlood #Northglenn Found pale grey tabby kitty, doesn't look very old. Long haired, very high pitched... URL	Affected individuals
RT @BrockJays: I want to send out my love and thoughts to everyone in QLD effected by the floods!! Be safe and look after your families! ...	Sympathy and support
37 #photos of the Colorado floods,  via @big_picture URL	Other Useful Information
RT @littlemissmocha: RT @seamusoregan: BREAKING: 1,200 troops being deployed to help with flooding in Alberta. @CTVNews	Donations and volunteering
RT @MetroAnnalise: View from my office window. Lots of debris in North Saskatchewan River in #yeg #abflood URL	Other Useful Information
@cityoflongmont ordering mandatory evacuations in the Southmoor Park neighborhood. #COFlood	Caution and advice
orz south east qld is flooding.	Other Useful Information
RT @Cmdr_Hadfield: Hello Australia! Last night I I stayed up late to take a few photos of the flooding in the Northeast, which I'll be p ...	Other Useful Information
Have no power due to flooding. Go to OTooles Corinda asj if I can charge my phone for a bit and was told no. #bigwet	Infrastructure and utilities
RT @weathernetwork: RT @fionnscalgary looking at bowness park flooding URL #yycflood	Infrastructure and utilities
RT @9NEWS: #BoulderFlood: up to 12,000 structures are currently threatened. #COFlood	Infrastructure and utilities
RT @aimeemay: Boulder healers volunteer to help rebuild community after devastating flood - #Boulderflood URL via @daily‚Ä¶	Donations and volunteering
‚Äú@snoozen: Bet mine isn't only child hoping for a #bigwet delay school resumptions‚Äù No we want beautiful day to remember Preppies first day!	Affected individuals
It is eerily quiet downtown. Only noises are water dripping and sirens #yycflood	Other Useful Information
@ijournal #Energy Industry Liability #Insurance May Cover Contamination Claims From Colorado #Flooding URL @Dickstein_LLP	Donations and volunteering
RT @theqldpremier: I'd like to thank Marius Kloppers and BHP Billiton for their $ 1 million donation to the Qld Flood Appeal	Donations and volunteering
RT @CBCCalgary: Rain floods Calgary landmarks URL	Infrastructure and utilities
RT @CalgaryPolice: Clarifying a rumour for #yyc. There are NO zoo animals being sheltered at the Courts. #yycflood	Other Useful Information
RT @Real_Rodeo: Some prayers going out for the Calgary stampede. #flood #prayers	Sympathy and support
RT @YuriHiranuma: Death toll rises in Colorado floods with another feared dead URL via @reuters  „Ç≥„É≠„É©„Éâ„ÅÆÊ≠¥Âè≤ÁöÑ„Å™Ê¥™Ê∞¥„ÅÆÁèæÊôÇÁÇπ„Åß„ÅÆÊ≠ªËÄÖ4‰∫∫„ÄÅË°å‚Ä¶	Affected individuals
RT @Eric_Doherty: #Enbridge shuts #tarsands pipelines after spill likely caused by #abflood URL  #Cdnpoli #abpoli #clima‚Ä¶	Infrastructure and utilities
RT @612brisbane: Keep up to date with the latest flood warnings from the Bureau of Meteorology URL #qldfloods #bigwet	Caution and advice
This is what's been happening at home RT @the_daily: Latest Sunshine Coast wild weather photos: URL #bigwet	Other Useful Information
RT @TheoFleury14: BREAKING: Water is up to row 10 at Saddledome. Dressing rooms completely submerged. #yycflood #NHL‚Äù	Infrastructure and utilities
Floods to wash away Virgin doubts: The return of floods to Queensland, and the disruption to leisure aviation th... URL	Other Useful Information
RT @Rasta_: For Queensland. #bigwet URL	Sympathy and support
Drama continues as rivers keep rising: QUEENSLAND'S flood emergency is not over yet, with entire suburbs in Bund... URL	Caution and advice
RT @latimes: Colorado flooding: Environmental toll compounds the troubles URL	Infrastructure and utilities
RT @MinisterJono: Out near High River - incredible devastation by the rising waters. #ableg #abflood	Infrastructure and utilities
#india #latest news Major floods hammer northern Australia URL	Other Useful Information
Moral of the story - if you‚Äôve elderly neighbours, check on them and ensure they have the latest information. Thanks Mum #bigwet #qldflood	Caution and advice
RT @canartca: More on Alberta flood impact on artists from Calgary artist Suzen Green's blog  URL	Affected individuals
Phones are still open15 more mins #COFloodRelief 1-877-667-6727 is the number to help your fellow Coloradoans!!!! #CO  #floodvictims	Donations and volunteering
RT @SAITPolytechnic: We've opened residences to those evacuated due to #yycflood. If you need lodging visit an #ABemerg Response centre fir‚Ä¶	Donations and volunteering
RT @weathernetwork: RT @margovisser BOW CRESCENT FLOODING!! View from Silver Springs hill. #yycflood #bowness #calgary URL	Infrastructure and utilities
RT @DenverChannel: Please RT: #COFloodRelief fundraiser just started: URL	Donations and volunteering
RT @calgaryzoo: We have an estimated $50 million in flood damage, and $10 million in lost revenue due to closure for repairs. #yycflood #yyc	Infrastructure and utilities
Eighth confirmed death in Colorado flooding - CNN URL	Affected individuals
Flooding hits eastern Australia: Hundreds of homes are inundated and and several people reported missing as floo... URL	Affected individuals
Northeast Colorado residents are struggling with intense flooding as more rain is forecast for the region.	Affected individuals
EcoWater Reviews Pure Drinking Water After Colorado Floods: EcoWater reviews strategies that... URL #drinkingwater	Infrastructure and utilities
RT @denverpost: ALERT: Larimer County adds to number of people presumed killed in flood: URL #coflood	Affected individuals
RT @ETownMickey: I hate when innocent animals suffer RT @ampcalgary Poor poor Harvey the Hound. #yyc #yycflood #abflood #saddledome URL	Other Useful Information
230 000 homes &amp; businesses now without power in seq according to @energex. #qldfloods	Infrastructure and utilities
@James_Yammouni Awwe I wish i could go but atm im in qld about to drown in flood waters! NO FUCKING JOKE IM ACTUALLY ON MY ROOF ATM!	Sympathy and support
Thank you everyone who is out there effortlessly working immensely hard to protect us from the @AlbertaFlood #yycflood  #Alberta	Sympathy and support
@jhutch1992 sounds like something they would be telling people in Australia right now with all the flooding we've had :/	Other Useful Information
RT @AnimalPlanet: How are animals weathering the storm as floods sweep through Colorado? Click ahead for more on rescue efforts &gt;&gt; URL	Affected individuals
RT @Weishampel: #Boulderflood road closures: URL many North #Boulder roads, just about every canyon. Stay home.	Infrastructure and utilities
Swift water rescue underway at Gilston #bigwet	Caution and advice
Insurers get nervous: Insurers brace for a new round of claims following heavy rains and flooding in Queensland ... URL	Affected individuals
#CruzRoja: Misi√≥n, Visi√≥n y Principales Objectivos ‚òë URL | #RedCross #COFlood #cofloods #coflooding #CO #COFloodRelief	Donations and volunteering
RT @joshbavas: This new satellite image shows the sheer size of the system moving across Queensland right now. #bigwet URL	Other Useful Information
RT @cityofcalgary: More good news! All single-family dwellings outside the downtown core have been cleared for reoccupation. #yycflood	Infrastructure and utilities
Second flood death in Qld URL	Affected individuals
RT @blynch1020: #boulderflood no school for me URL	Infrastructure and utilities
RT @7NewsBrisbane: This is (we think) a Grey Wolf #Spider escorting her young to safety from flooding in #Jandowae #bigwet #qldfloods ht ...	Other Useful Information
San Francisco Chronicle Roads in Northern Colorado Reopen as Floods Recede The Charlottesville Newsplex DENVER... URL	Other Useful Information
Guys, this picture of a tornado has absolutely nothing to do with today‚Äôs weather in QLD. #bnestorm #bigwet #tornado URL	Affected individuals
RT @cote14er: Hwy 119 between Longmont and I-25 is open. Cut off about 20 minutes from my drive this morning. #COFlood	Infrastructure and utilities
RT @Crackmacs: 7th ave is vacant, other than pedestrians and skateboarders #yyc #yycflood URL	Infrastructure and utilities
RT @reedtimmerTVN: Beautiful picture of dusting of #snow in #Colorado mountains from yesterday after tragic flooding‚Ä¶ URL	Not applicable
RT @visiglobal: Our hearts go out to those affected by the severe flooding in western Canada. Love and prayers to you from your entire V√≠si‚Ä¶	Sympathy and support
RT @kevinzahara: @CampbellMLA surveys damage at Hidden Valley.  Unbelievable damage.  #abflood URL	Infrastructure and utilities
RT @612brisbane: Brisbane River near Eagle Street...20 mins until high tide.  #bigwet URL	Caution and advice
RT @Cal_OES: RT @femaregion8: 9/19 How Colorado state agencies are supporting #COflood response URL (via @COEmergency)	Donations and volunteering
#bigwet is Fehlberg Park in Fairfield going under this time?	Other Useful Information
URL Maryborough Queensland Golf Club in flood January 28th 2013 URL #Golf #USGA #LPGA	Infrastructure and utilities
Impact of government shutdown on federal flood relief in Colorado unclear (URL  #govshutdown #coloradoflood	Donations and volunteering
RT @abcwidebay: Here's another gallery of photos of flooding from the Bundaberg region #bigwet URL @abcnews	Other Useful Information
Flash floods wash away homes, kill at least one near Boulder, Colorado - U.S. News URL via @NBCnews	Affected individuals
Will be on with @RobBreakenridge in a few moments to talk about what's going on at the Bonnybrook Bridge &amp; other #yycflood issues.	Infrastructure and utilities
There's dihydrogen monixide everywhere! #bnestorm #bigwet	Other Useful Information
MT @BoulderOEM: RTD will have regular routes tomorrow except for the Y, YL &amp; N. The DASH is detoured around S. Boulder. #boulderflood	Infrastructure and utilities
District 6 could lose millions in funding because of floods: With just a few days until students in Colorado are... URL	Infrastructure and utilities
Colorado flooding doesn't stop Postal Service URL	Infrastructure and utilities
Praying for Alberta. #flooding	Sympathy and support
Student captures flash flooding on University of Colorado campus URL	Infrastructure and utilities
Photos: Severe flooding in Australia URL	Caution and advice
Family is safe and I have a full box of Yorkshire Tea. #readyforanything #yycflood	Affected individuals
RT @windspeakernews: Thursday morning update on donations to assist southern Alberta First nations impacted by flooding. URL	Donations and volunteering
RT @AFN_Updates: #AFN National Chief @shawnatleo w/ Stoney Nation volunteers in Morley, AB today #abflood URL	Donations and volunteering
#ableg #yycflood Extreme Weather Adds Up to Troubling Future URL Poor communities no support like in Calgary. They die.	Other Useful Information
Final exams are cancelled due to the flooding! The only good thing it brought :D bless Calgary hallelujah üòé	Infrastructure and utilities
RT @pennyskateboard: Our hearts go out to all those affected by the Queensland floods. Stay safe everyone. #qld URL	Sympathy and support
Waiting to hear from some of my family who live outside of #Boulder #BoulderFlood  in Gol Hill	Other Useful Information
RT @9NewsBrisbane: RT @Simon_C_Ward: Eagle St pier has gone under again. Restaurants inundated. @9NewsBrisbane #bigwet URL	Affected individuals
RT @calgaryherald: Here's our story on diploma exam situation: URL #yyc #yycflood	Not applicable
RT @A_Long_Bear: Btw it just blows me away that over 1200 people are still unaccounted for from the floods that have hit Colorado. #unthink‚Ä¶	Affected individuals
#lyons #boulderflood Here is what is left of Shelly's Cabins off of 36 West of Lyons. URL	Infrastructure and utilities
@TricoHomes @HomesbyAvi @Stepperhomes Have you heard about the #YYCFlood Red Cross Challenge yet? URL	Donations and volunteering
Somewhat positive note: I now have a badass story to tell my grand kids while I'm hanging in the old folks home. #AbFlood	Other Useful Information
Live: Qld flooding alert moves south - ABC Online: Sydney Morning HeraldLive: Qld flooding alert moves southABC ... URL	Caution and advice
#news Canada floods 'could force 100,000 from homes': As many as 100,000 people could be forced to fle... URL #follow	Affected individuals
RT @m_hollett: Heat wave in Alaska, floods in Alberta, killer smog in Singapore, yeah, this global warning stuff is crap. Let's laugh at pl‚Ä¶	Other Useful Information
Flood-weary Calgarians soak up Canada Day celebrations: For a city that's proven its spirit, dedication and re... URL	Sympathy and support
Flooding, Stranded, Emotions Rise in Colorado - The flooded area of Colorado is reportedly the size  URL	Affected individuals
RT @paul_dunphy: We're now hearing that the Saddledome  might be half-filled with water. #yyc #abflood	Infrastructure and utilities
RT @Mookalicious: This pic of an awesome firefighter in Mission needs to go viral.  Please share! #abflood URL	Other Useful Information
Floods Put Strain on Australia's Economy - Wall Street Journal: Sky News AustraliaFloods Put Strain on Australia... URL	Other Useful Information
RT @CIAwesome: LIVE FEED: Bow River at the 10th Street bridge by Kensington URL #yycflood #abflood via @GlobalCalgary	Infrastructure and utilities
RT @denverpost: Larimer County officials say number of people unaccounted for in #COflood has dropped to 60: URL	Affected individuals
RT @indigojourney: You dont have 2 ask permission, U see problem &amp; solution...encourage leaderhsip roles #occupy #floodrelief #coflood ht‚Ä¶	Other Useful Information
RT @ShawTVCalgary: The Calgary Zoo moved the lions and tigers to cells at the Calgary Court House. Yes - you read that correctly! #yycflood	Donations and volunteering
Australia issues #flood warning as mini #tornado hits URL	Caution and advice
RT @cbcDougDirks: @nenshi If you're still standing, @WBrettWilson donating $1 for every tweet, RT of hashtag #OMGP to max 50k for #yycflood‚Ä¶	Donations and volunteering
Rain is pouring again... #abflood	Other Useful Information
RT @daxjustin: #yycflood #yycfloodhero @CanadianForces working hard to keep East @InglewoodYYC safe. URL via @philandseb	Donations and volunteering
RT @Cameron_Gray: Please remember to also help #COPets when you're helping those affected by the #COFlood	Donations and volunteering
Only in Australia do u find a woman outside in the middle of a flood cutting her hedge that is completely underwater	Other Useful Information
Hundreds missing in Colorado floods URL	Affected individuals
RT @theqldpremier: Warwick - About 20 businesses were inundated. The area is now in clean up mode. - PT #bigwet	Infrastructure and utilities
RT @Channel9: QLD viewers: Premier Campbell Newman confirms parts of Ipswich &amp; Brisbane susceptible to flooding; LIVE News @ 9.30pm  ...	Caution and advice
The water under the Boulder Creek/Broadway underpass silted up #boulderflood #aftermath @ Boulder Creek URL	Not applicable
RT @RobertFife: Conservatives postpone next weekend's convention in Calgary because of flood waters #cdnpoli	Other Useful Information
Queensland's flood crisis deepens - The Australian: Sydney Morning HeraldQueensland's flood crisis deepensThe Au... URL	Caution and advice
Floods in Queensland worst on record - Irish Times: Sydney Morning HeraldFloods in Queensland worst on recordIri... URL	Other Useful Information
RT @RGIII: Please pray my family in Colorado and all others impacted by the #boulderflood	Sympathy and support
RT @sarashadid1: So many tragedies that our country is facing! Praying for those in DC and Colorado #NavyYardShooting #coloradoflood God he‚Ä¶	Sympathy and support
RT @abcnews: Thousands of Queensland flood victims join possible class action against State Government URL	Other Useful Information
Thanks for making fun of us, Google. #jerks #yycflood URL	Other Useful Information
@cityofcalgary: Plz RT Public Schools (CBE &amp; Catholic) will be CLOSED on Monday. #yyc #yycflood @MariamAwara	Infrastructure and utilities
RT @mikedmonton: Water about to crest over Bassano Dam #abflood #mhflood URL	Infrastructure and utilities
RT @HMB_SLSC: SLSC Australia: SLS is encouraging everyone to play it safe in flood affected areas. Don‚Ä¶ URL	Affected individuals
RT @mapsgirl: Show your support to people affected by Alberta floods by donating to @redcrosscanada: URL #abflood Pls RT‚Ä¶	Donations and volunteering
#COflood update in @bouldercounty: Re-entry passes available for Lyons residents tomorrow-- dawn to dusk entry	Affected individuals
#flood #disaster What will Colorado floods mean for affordable housing? - Denver Post: What will Colorado floo... URL	Other Useful Information
BBC : VIDEO: Floods cause chaos in Queensland URL	Other Useful Information
The #Colorado flood's impact on real estate: URL #coflood #homevalues	Infrastructure and utilities
RT @mikemangas: A Redding woman describes her Granddaughter's escape from disaster in the Colorado flooding. Tonight on KRCR News Channel 7.	Affected individuals
Hundreds of people are unaccounted for across the US state of Colorado as heavy flooding inundates mountain... URL	Affected individuals
@fan960walker @fan960boomer let's figure out a way to give #boomersseats to either someone out of home or a 1st responder #yycflood	Donations and volunteering
RT @QPSmedia: Severe weather warning updated - strong winds up to 125km/hr possible in SE Coast district #bigwet URL	Caution and advice
@AlwaysLyndsay check out the City's blog for critical updates on affected areas URL #yycflood	Caution and advice
Awesome‚Äú@Mo_K_Miller: A sea of volunteers at McMahon ... So many it's threatening to overwhelm officials #abflood URL	Donations and volunteering
RT @SkipIsChris: Companies like @HomeDepotCanada need a wake up call. Please RT and help spread the word. #abflood #yycflood URL	Sympathy and support
RT @TheTimMcGraw: Thoughts, prayers and love to everyone affected by the flooding in Calgary.  Needed 2 postpone our show this week, but it‚Ä¶	Sympathy and support
RT @cbldatarecovery: Found hard drive water-damage in flood cleanup? First-response for your data in Calgary @TechSquad URL	Donations and volunteering
Insurance News:Massive Floods Hit Queensland, New So. Wales; 4 Dead, Thousands Evacuated	Affected individuals
DBJ special report: Colorado's floods URL #denver	Other Useful Information
RT @COEmergency: To register for FEMA disaster assistance: URL #COflood	Donations and volunteering
#boulder I hope you're okay. #boulderflood	Sympathy and support
RT @michaelstrahan: My thoughts and prayers go out to everyone in Colorado dealing with the floods and also to everyone in D.C at the Navy ‚Ä¶	Sympathy and support
Kum &amp; Go Donates $15,000 to American Red Cross; Helps communities affected by Colorado flooding. Read more:... URL	Donations and volunteering
RT @Reuters: Eight confirmed dead, 1,600 homes destroyed in Colorado floods URL	Infrastructure and utilities
RT @findingcam: Elbow falls in Calgary,Canada pre flood and now a few hours ago. Stay safe Calgary via @chadmsaunders #calgaryflood URL	Sympathy and support
'Move to high ground:' Rapid flooding forces evacuation of High River URL #yyc #Calgary #yycre #reincal	Caution and advice
Clean-up launched after deadly Australia floods: SYDNEY: A mammoth clean-up was underway in Austral... URL via @fmtoday	Affected individuals
RT @thinkprogress: Colorado's oil and gas industry not prepared for floods, 5K gallons of crude spill into major river URL	Infrastructure and utilities
RT @7NewsBrisbane: Careful on the roads around Burnett Highway; viewer Jackie Bolsover took this shot on the way to Biloela. #qldfloods  ...	Caution and advice
Flooding by #UCCS has moved traffic cones into middle of traffic on Austin Bluffs by Union, stay safe out there!  #coflood	Caution and advice
Hello #world #Happy #Friday #everyone And #wishing our #friends in #Australia who are #suffering from #floods stay #safe :-0)	Sympathy and support
@IdilioMon: #coloradoflood ==&gt; Street view from my home this afternoon. Rain, rain, go away... URL	Other Useful Information
This Heartbreaking Video Brings Humanity to Colorado Flooding Disaster URL	Other Useful Information
RT @DavidCurnowABC: Toowoomba not spared wind and destruction. #bigwet #staysafe #ABCNews URL	Infrastructure and utilities
RT @AaronLucasBris: PHOTO: Brisbane River almost bursting its banks at Bulimba on high tide. #qldflooding #bigwet URL	Infrastructure and utilities
Banff Marathon and K100 both cancelled due to the flood situation in southern Alberta as runners rally to help in the flood effort	Caution and advice
RT @JohnFromCranber: H Reid blames Colorado flooding on #Climate Change: URL Libs Holy Mantra happily used for any/eve‚Ä¶	Other Useful Information
RT @7NewsBrisbane: Flood Flag Maps from the Brisbane City Council. #bigwet #bnestorm URL	Caution and advice
RT @KathrynMombo: Thoughts and prayers are with everyone affected by the floods! #StaySafe! #abflood	Sympathy and support
News From Australia - captainmjolnir: Queensland is flooded (again) New South Wales is flooding (again)... URL	Other Useful Information
RT @VonnettaLWest: Praying for those affected by flooding in Colorado &amp; researching ways to help #OurNeighbors there!	Sympathy and support
Pretty scary, the events of the last few days... Lac Megantic train, SFO crash, Toronto and Calgary floods... What's going on?	Sympathy and support
Cotton Outlook Seen Improving in Australia After Floods, Rains URL	Other Useful Information
My photos of the flooded Bicentennial Bikeway are up. #bigwet URL	Other Useful Information
RT @Amelia__Earhart: Here's the Lakewood High School @katyperry music video! RT to get Katy to come to CO with #coflood relief! URL	Donations and volunteering
flood maps queensland URL	Other Useful Information
#BREAKING #COflood: Helicopters from Ft. Carson and @CONG1860 have evacuated 1162 people in  @bouldercounty - per Mitch Utterback	Affected individuals
RT @COPetEmergency: #Found Lab found  #COFlood URL	Affected individuals
@WesWelker Can you please help my friend wyl who lost his home and business in the Colorado floods URL Please spread.	Donations and volunteering
Sending love and dry wishes to my friends and clients in Queensland and northern nsw, who are in the line of the flooding.	Sympathy and support
Everything is going to be ok, Karl Stefanovic will be reporting on the floods from Brisbane #bigwet #calminginfluence #logie	Caution and advice
RT @michaelstrahan: My thoughts and prayers go out to everyone in Colorado dealing with the floods and also to everyone in D.C at the Navy ‚Ä¶	Sympathy and support
RT @hilltophereford: In The Wake Of Colorado‚Äôs Devastating Floods, 5,250 Gallons Of Crude Oil Spill Into Major River URL	Infrastructure and utilities
RT @BoulderCh1News: scanner #boulderflood reports Lee Road rock slide road is closed	Infrastructure and utilities
Clean up day #bigwet URL	Affected individuals
RT @marcbinkley: Donate to the Alberta Floods Fund URL	Donations and volunteering
The flood in Calgary is a lot more serious than we're led to believe. They are just sandbagging.	Other Useful Information
Flooding forces evacuation of downtown Calgary, 75,000 residents: Flooding forced the western Canadian city of... URL	Affected individuals
Wow- plowing out the mud from the bike path I use everyday #boulderflood URL	Infrastructure and utilities
RT @TSHowell: Price fixing is illegal under emergency act and individuals could be prosecuted, says city's CEMA director. #yycflood #chlive	Caution and advice
Media Ignores Damaged Oil &amp; Gas Tanks from Colorado Flooding URL	Infrastructure and utilities
RT @BOMQld: BOM update: 26/12:42 EST Flood Warning - Burnett River (QLD) URL	Caution and advice
RT @BCIAustralia: Premier Campbell Newman talks of dams, levees in rebuild plan after devastating floods #australia #construction URL ...	Caution and advice
RT @COEmergency: Gov. Hickenlooper announces additional $20 million... URL #coflood	Donations and volunteering
Know what's going on in your country. #disasters #nature #destruction 3 dead, hundreds evacuated in Colorado flooding URL	Affected individuals
RT @CgyCA: Power could be out in downtown #Calgary for days: URL #abflood #yycflood #yyc	Infrastructure and utilities
RT @premierministre: Mille fois merci @calgarypolice, @cgyfirefighters &amp; @cityofcalgary pour tout ce travail. Soyez prudent. #abflood #yycf‚Ä¶	Sympathy and support
Two dead, several structures destroyed in Colo. flooding: Hundreds of University of Colorado-Boulder students ... URL	Affected individuals
RT @CitySouthNews: The clean up's on at Tarragindi #bigwet URL	Other Useful Information
RT @greeleygov: DISASTER ASSISTANCE: if you've sustained losses or damages due to the #coflood, call 1-800-621-FEMA (3362) URL	Caution and advice
Poser RT @MissKayeSera: TWO sand bags, Tony. That's gonna make a huge difference! #abbottstunts #bigwet #Qld URL	Other Useful Information
RT @DebraWard: #yyc gougher  MT @rsinghphoto Everyone should boycott @TravelodgeCa hotels!  #yycFlood #yycGreedy #ABFloods URL	Other Useful Information
RT @triplej: Want to help out the people of QLD doing it tough right now? Be a total legend and donate to the Floods Appeal here URL ...	Donations and volunteering
URL Brisbane has 6 hours worth of water left #sun7 #bigwet #qldfloods	Caution and advice
RT @Premier_Redford: Today, we begin to rebuild from #abflood. Read my full statement to Albertans here: URL #ableg #cdn‚Ä¶	Other Useful Information
Severe Weather Warning issued for #Scenicrim #bigwet URL	Caution and advice
RT @ChantzyO: New to #yyc and doing my part to clean up. Amazing support. #abflood #yycflood #calgarystrong URL	Donations and volunteering
Here we go again with the rain. #boulderflood URL	Sympathy and support
Go Bandit! RT @mitchellbyars: Bandit the live-rescue dog is trained to find live people under rubble URL #boulderflood	Other Useful Information
8th confirmed flooding death in Colorado URL	Affected individuals
RT @9NEWS: Wall of water floods Colorado, kills 2 URL #9NEWS	Affected individuals
RT @989JetFM: Here's how you can help out our provincial neighbours in #Alberta: URL - Matt #abflood	Donations and volunteering
RT @GreenboxStorage: @WestwordStreet We're giving free storage to victims of the #COFlood Will you help spread the word? #COFloodRelief htt‚Ä¶	Donations and volunteering
RT @theqldpremier: I'd like to thank Marius Kloppers and BHP Billiton for their $ 1 million donation to the Qld Flood Appeal	Donations and volunteering
Weld county officials writing down concerns on a board in front of citizens #coflood URL	Other Useful Information
RT @smh: Some more details on the evacuation order issued for #Grafton - #SES says this is a 'flood of record'. #bigwet URL	Caution and advice
BLOG: Is #Alberta #flooding a sign of climate change? Asks @DavidSuzukiFDN URL via @huffpostalberta	Other Useful Information
RT @SNVredcross: In addition to the Colorado flooding, #RedCross has provided food &amp; shelter to people affected by flooding in Guam, UT, AZ‚Ä¶	Donations and volunteering
RT @MitchChrist: I Smashed 200grand worth of liquor at the dome today. And washed the bobcat window with a bottle of patron. #abflood #yyc	Not applicable
RT @lieml: @joerogan At least two large oil spills have been confirmed in the wake of Colorado's historic floods -URL	Infrastructure and utilities
RT @mikesbloggity: Until Sunday, Tide is washing clothes for free at Glenmore Coin Laundry. #yycflood	Donations and volunteering
RT @BreakingMemo: Death Toll From Colorado Floods Rises To Eight URL	Affected individuals
Flooding hits eastern Australia: Hundreds of homes are inundated and and several people reported missing as floo... URL	Affected individuals
# brisbane river is decreasing slowly thank GOD # Qld floods	Other Useful Information
RT @nenshi: The Calgary Foundation has established a flood recovery fund. This is a great place to make donations. URL	Donations and volunteering
RT @GirlReporter: Workers who have lost five days or more of work can apply for EI #yycflood	Caution and advice
RT @ENMAX: CEMA has directed certain outages in the downtown core. CEMA will advise @ENMAX when it is safe to restore power. #yycflood	Infrastructure and utilities
BEAGLE NEWS ALERT Photos: Heavy flooding hits Australia:  URL	Other Useful Information
RT @CBSDenver: #WhiteHouse announces VP Joe Biden will visit #COFlood areas Monday, speak in Greeley w/ Gov. Hickenlooper &amp; FEMA's Fugate i‚Ä¶	Other Useful Information
RT @nicolerrabbit: @sandraklis: The river now! Getting dark and headin for higher ground now, everyone stay safe! #yyc #yycflood URL	Infrastructure and utilities
@ValFortney column: Once-cheerful High River transformed into ghost town URL #yyc #yycflood URL	Other Useful Information
RT @Philippa_Kate: Cars completely covered at work yard on Walla Street. #bigwet #bundaberg URL	Other Useful Information
Rain is still pouring down in #Colorado. 500 unaccounted for by the #floods, hopefully rescue efforts are successful.	Affected individuals
RT @YourAnonNews: Broken Oil Pipeline in Weld County, CO After #COflood URL	Infrastructure and utilities
RT @hpliszka: #abflood hit #Siksika tremendously hard. Thx @1anhaga for link to powerful song &amp; photos The Ballad of Crowfoot URL	Not applicable
Everyone stay safe in the #BoulderFlood! Especially those having to be evacuated. It's getting dangerous.	Sympathy and support
RT @breakingstorm: 482 people unaccounted for in Larimer County, Colorado, after flooding - @LarimerSheriff URL	Affected individuals
Telus has made it even easier to donate. Text REDCROSS to 30333 to donate $5 in support of #ABfloods #yycflood via @RedCrossAB	Donations and volunteering
10am gathering @DaDeGallery for cleanup effort today! I'll join when I can around 11:30/noon. Keep me posted on location #yycflood #yychelps	Donations and volunteering
RT @FFWDWeekly: 25th Ave. Erlton/Mission #yycflood URL	Not applicable
RT @NASA: Colorado flooding near Greeley: comparison view from Landsat 8. URL @NASA_Landsat @USGSLandsat @NASA_EO	Other Useful Information
RT @kejames: Six dead, 1,253 unaccounted for, 17,494 homes damaged, and 1,502 homes destroyed in Colorado floods. URL	Affected individuals
QPS Facebook page has changed URL since two years ago.  Good resource for #bigwet #qldfloods information.  New page: URL	Other Useful Information
Wow that storm hit quickly and packed a punch! @abcsouthqld #bigwet #Toowoomba It's not what people who are cleaning up need.	Other Useful Information
Tune into @NewsTalk4BC 1116 AM or stream online URL  for rolling coverage on the worsening weather conditions #bigwet	Caution and advice
RT @Mookalicious: The Calgary Stampede's answer to whether or not they will proceed this year?! #abflood URL	Other Useful Information
Australia floods trap hundreds URL	Affected individuals
RT @7NewsBrisbane: If you are without TV reception, Yahoo!7 is streaming live rolling coverage here: URL #bigwet #qldfl ...	Other Useful Information
RT @abcnews: GALLERY: Flooding hits Qld's Sunshine Coast. See a selection of photos from @abcsunshine URL URL ...	Caution and advice
@dsportsmedia Didn't realize you had a concussion. How did it happen? Was referring more to the recovery in Calgary from the flooding. :)	Not applicable
RT @NewsTalk770: Nenshi says welcome back to the downtown...we are open for business!#yycflood	Infrastructure and utilities
RT @asketchyfish: USGS/NWS looks to have accurate numbers. Holding my breath this afternoon with more rain on the way. #BoulderFlood URL	Other Useful Information
RT @DenverChannel: Larimer County says this is 1,000-year flood. Pic of Big Thompson Canyon #COflood URL URL	Other Useful Information
RT @sarfoss: RT @sjrtitan: #yycflood help is on full force and coming URL #SMEM and there go the troops #abfloods	Donations and volunteering
Howling wind outside, howling kids inside! Can't win! #bigwet #qldweather	Not applicable
RT @CPPGeophysics: Map with before-and-after photos of the 2013 Colorado floods: URL	Infrastructure and utilities
RT @shipcompliant: We're organizing happy hour for #cofloodrelief this Thursday at Kitchen Next Door. 100% of the profits to Red Cross floo‚Ä¶	Donations and volunteering
RT @TreanMachine: Currumbin ... #cyclone #wildweather #bigwet #TheAlley  @ Currumbin Beach URL	Other Useful Information
RT @cityofcalgary: #yyc water quality is good. But, we ask you to reduce water usage to reduce demand on treatment plants. #yycflood URL	Caution and advice
BBC News - Colorado floods: Hundreds still missing URL	Affected individuals
For the victims of the #coloradoflood, here's #hope from a picture I took at Four Corners this summer. URL	Sympathy and support
Hundreds of Cats Needing Help From Colorado Floods! Please help... : URL via @LuAnnSmithGCM #cats #catrescue	Other Useful Information
RT @JGeorgitis: #Boulderflood Anyone need help?  I live in Holiday neighborhood, Yarmouth and 17th and can get to you if you are close by.	Donations and volunteering
Thoughts go out to everyone affected by the floods in Queensland! xx	Sympathy and support
Rescuers battle Australia floods URL	Other Useful Information
RT @TheRoyGreenShow: Listen to a from the heart description of the flooding from Calgary resident Mae on URL podcast. HR‚Ä¶	Sympathy and support
Pygmy whales washed up in huge swells URL @abcnews #bigwet	Other Useful Information
.RT @bouldercounty: See tags/flags at home? LEAVE THEM IN PLACE. They're 4 search &amp; rescue URL #boulderflood #COFlood	Caution and advice
i wonder if queensland is going to have another one of those times where it floods for a whole week before school starts	Other Useful Information
RT @EmergencyVol: Assistance is available for those affected by #qldfloods. See Queensland Govt website for more info URL	Donations and volunteering
I believe this is the golf course at Canadian Golf Academy. Driving Range and Lafarge in background. #yycflood URL	Infrastructure and utilities
RT @patriciazakhem: Tune in to 7NEWS now to help our neighbors in need! $724,264 so far and counting! #COFloodRelief @RedCrossDenver URL	Donations and volunteering
RT @femaregion8: The *best way* to help #coflood survivors, first visit URL . This is how you make the greatest impact. ‚Ä¶	Donations and volunteering
My heart goes out to everyone who have been affected by the floods... We are a strong region &amp; we will be fine!!! @australia @queensland	Sympathy and support
Bon Iver - Calgary URL #mvod 1040. My heart goes out to all Calgarians and Albertans affected by the flood.	Sympathy and support
RT @RT_com: Devastating floods strike Queensland, disaster declared URL	Other Useful Information
RT @finleybruce: Scenes from St. Vrain south of Miliken. #cowx #COflood URL	Infrastructure and utilities
Qld again in grip of deadly flood disaster - Yahoo!7: At least four people are feared dead in Queensland's unfol... URL	Affected individuals
So when disaster strikes #bigwet u lose power, water and smartphone (no charger, no telstra). Surprising how dependent u are on iPhone!	Other Useful Information
RT @judithmaizey: @SpencerHowson Motorists Re not getting the message about Loganlea Rd being closed. URL #bigwet	Infrastructure and utilities
RT @COpetpantry: We're partnering w/ @HumaneBoulder to help displaced #boulderflood/#coflood victims feed #pets. To help: plz donate: URL	Donations and volunteering
RT @abcwidebay: You'll find information here on the North Bundaberg Evacuation #bigwet URL	Donations and volunteering
#Calgary! Here is your @CalgaryPolice #Hawc helicopter patrolling the downtown core last night.  #YYcflood URL	Infrastructure and utilities
yep this is all i could think of haha stay safe errbody #yycfloods #yyc #abstorm #abfloods URL	Sympathy and support
RT @BBCWorld: Australian state of #Queensland on alert for more tornadoes &amp; #floods - VIDEO URL	Other Useful Information
RT @femaregion8: For immediate, short-term #COflood legal assistance, go to URL or call toll-free 855-424-5347. @FEMA	Donations and volunteering
RT @IAmJodiHughes: Great article from @weathernetwork about why we had so much rain: URL #ABflood	Other Useful Information
RT @karencrummy: Just informed by national guard that the Mud up to my knees isn't mud.   Shit.   #coflood	Caution and advice
QLD floods I have no electricity or hot water &amp;just got cell service &amp;Internet back on my phone. First thing I check @JessicaCapshaw twitter	Infrastructure and utilities
@JZ_Blue Thanks for the Love Bro. I'll be fine however many are not and our best wishes and prayers go out to them all. #COFlood	Sympathy and support
RT @weathernetwork: Stampeding to recovery: Calgary rodeo to go ahead as planned: URL #abflood	Caution and advice
OMG IT'S LIKE FLOODING SOME PARTS OF AUSTRALIA. I'M PRAYING, HOLY CRAP. IT HASN'T STOPPED RAINING.	Sympathy and support
7 shocking photos of Colorado's flash floods URL	Infrastructure and utilities
help plz  the 1500 residents of wedgewoods at discovery ridge..Pootman not helping #abflood #yycflood @pootman plz get some relief advise	Affected individuals
RT @ABCNews24: #QLDfloods: Authorities are warning of tornadoes for #SunshineCoast &amp; #Brisbane. We are live to #Brisbane next URL ...	Caution and advice
Homes spared from flooding for now - Sydney Morning Herald URL #qld	Infrastructure and utilities
EQECAT: Colorado Floods $2B in Economic Losses and Climbing URL	Infrastructure and utilities
#COflood update on @bouldercolorado: Crews have cleared a large amount of debris - at max capacity at water treatment plant, per Huntley	Infrastructure and utilities
Thousands flee flooding in western Canada: At least four people are feared dead in Canada‚Äôs Alberta Province a... URL	Affected individuals
RT @dailycamera: Flood warning in place as 3/10 inch rain falls in 30 min in parts of county; rain to increase this afternoon #boulderflood	Caution and advice
RT @terrylo_calgary: #YYCFLOOD Request: Senior who lost everything needs household items URL	Donations and volunteering
Location for tomorrows green cleaning chemical donation pickup has changed. New location TBD. Will update ASAP. #yychelps #yyc #abflood	Donations and volunteering
RT @SummersAnne: QLD premier Campbell Newman I'm determined to ensure that this flooding won't be similar to the flooding of 2011. Kin ...	Other Useful Information
The weather is crazy over here..we have rivers now, &amp; some students are evacuating the dorms while others went mud sliding xD #boulderflood	Affected individuals
@brucehawker2010  says QLD is important for Gillard - why call an election during time of need during the floods @abc730 @abcnews ask Now	Other Useful Information
@craiglowndes888  So you're missing out on the QLD weather hey.  Perfect one day, Pissing down rain and flooding the next.. :)  Have fun	Other Useful Information
@CarlyMilan are you in QLD? I heard there was storm's, tornadoes and floods. I was in Boston for Aussie day so wast the same	Other Useful Information
RT @alex_ruiz: RCMP statement on @CBC news: there may be 4 casualties in High River :( #yycflood #abflood	Affected individuals
#bigwet #bnestorm hoping everyone in QLD and BNE stays safe during the floods. Thoughts are with friends there	Sympathy and support
RT @andrewmcintyre: Air shot of the extent of the Zoo flooding: URL #yyc #yycflood	Infrastructure and utilities
RT @TheoFleury14: BREAKING: Water is up to row 10 at Saddledome. Dressing rooms completely submerged. #yycflood #NHL‚Äù	Infrastructure and utilities
RT @CBCCalgary: Alberta flood-area building rules may change, says Redford URL	Infrastructure and utilities
@AzrielKnight: #yycflood Your Photos May Not Be Destroyed! URL @660News @Vistek @thecamerastore Please RT!!	Other Useful Information
URL #news Federal Tories delay Calgary convention due to floods - Toronto Sun URL	Other Useful Information
Rescuers battle Australia floods	Other Useful Information
Turn on ABC local radio if you really need updates urgently #bigwet @mollyarabella @ABCNews24	Caution and advice
RT @katiessummers: @CalgaryPolice please keep us updated on when/if volunteers will be needed - I'd love to help in any way I can #abflood ‚Ä¶	Donations and volunteering
RT @dailycamera: Fears remain about missing homeless in #Boulder County following flood URL #boulderflood	Affected individuals
RT @robotpilot: RT @DonC_Twit: Seriously, the URL doodle could not be more unfortunate today #yycflood #abflood #fail #d‚Ä¶	Other Useful Information
RT @QPSmedia Major flooding occurring in Lockyer Valley. Evacuations underway #bigwet	Caution and advice
RT @kendrahopaluk: People offering up all types of services on #Kijiji for the #yycflood victims. Seriously amazing. URL	Donations and volunteering
RT @BreitbartNews: Over 1,200 Missing in Colorado Flooding: A large area of Colorado, primarily Boulder County, has experienced e... URL	Affected individuals
No power? Save mobile phone battery: turn off background apps URL  #bigwet #qldfloods #nswfloods	Other Useful Information
SBS National: Southern Qld towns prepare for floods: Regional towns in Queensland's south are preparing for floo... URL	Infrastructure and utilities
RT @Metro_Katie: Extending the state of local emergency for an additional 7 days. #yycflood	Other Useful Information
.@theqldpremier Burnett River Bundaberg is expected to be peaking now #bigwet	Caution and advice
RT @NASA: Colorado flooding near Greeley: comparison view from Landsat 8. URL @NASA_Landsat @USGSLandsat @NASA_EO	Other Useful Information
Ipswich: Bremer River expected to peak at 15m, more than 200 properties to be affected. #bigwet	Caution and advice
After #bdbflood Sunrise #bundaberg #qld Feb02 #burnett_river highlighting #qldfloods ravaged banks URL ¬© @QPSmedia #bigwet	Infrastructure and utilities
Good news from Okotoks, where the Sheep River appears to have peaked, waters receding: URL #abflood	Infrastructure and utilities
RT @Calgary_Realtor: A google map showing #yyc evacuated area's. Extensive - much downtown. #yycflood #evacuated #community #yycre URL	Infrastructure and utilities
RT @7NewsBrisbane: Viewer Leslie sent in this picture of the Gold Coast hinterland in flood. #qldfloods #bigwet URL	Other Useful Information
RT @QLDOnline: RT @Cmdr_Hadfield: The flooding and flow into the Coral Sea at Gladstone, Australia - visible from the Space Station.  ht ...	Other Useful Information
RT @SAITPolytechnic: We've opened residences to those evacuated due to #yycflood. If you need lodging visit an #ABemerg Response centre fir‚Ä¶	Donations and volunteering
RT @ClimateCentral: Flood-ravaged Boulder sets mark as 2013 now the city‚Äôs wettest year URL #coflood #climate	Infrastructure and utilities
Reminder: If you need help from the SES, call 132 500 #QLDFlood #BigWet	Caution and advice
#Qldfloods might cause temporary banana shortage? Noooooooo! #fewernarniesmoothies Cc @SaintlySammi	Other Useful Information
RT @QLDOnline: Up to 14 luxury yachts &amp; houseboats have been washed ashore in the Whitsundays #qld #tcoswald #bigwet	Other Useful Information
RT @YourAnonNews: Meet the 4 Colorado republicans who voted against #Sandy aid, but now want aid for #COflood URL	Other Useful Information
RT @nenshi: Wonderful. MT @HWesleyE: A powerful and moving compilation of photos by @RADIOYYC of  #abflood view this video: URL	Not applicable
RT @Telstra: QLD FLOODS: Telstra encourages customers to only use their mobiles in emergency situations. If 000 is affected, call local  ...	Caution and advice
RT @7NewsBrisbane: Want to volunteer? Register first: URL and then download the app: URL #bigwet	Donations and volunteering
RT @HuffingtonPost: Colorado makes massive pet friendly rescue effort after flooding URL	Other Useful Information
RT @28storms: Colorado Flooding Pic: Home destroyed near Drake, CO, in the Thompson Canyon. Via Ryan Shepard Photography #COwx URL	Infrastructure and utilities
Calgary floods to cost economy billions URL	Other Useful Information
Frustration from residents about how &amp; why decisions were made on July 5. Applause for @HillhurstSunny residents. #yyc #yyccc #yycflood	Other Useful Information
RT @TylerV_YYC: ‚Äú@CstShaw: What used to be northbound Macleod Trail. #yycflood #yyc URL the awesome and yet destructive‚Ä¶	Infrastructure and utilities
RT @Metro_Katie: Once again, downtown Calgary will be evacuated as more buildings become compromised by flooding. #yycflood #abflood	Infrastructure and utilities
I know how to sandbag, use sump-pumps &amp; can carry things out of basements (slow-clap). I do want to help. #yyc #yychelps #yycflood	Donations and volunteering
@karlstefanovic  @QPSmedia say PLEASE don't dial 000 for road updates. Comms staff need lines free 4 emergencies. 131940 road info. #bigwet	Caution and advice
RT @cityofcalgary: City of Calgary NOT under boil water order. @AHS_media #yyc  URL #yycflood	Caution and advice
Shakespeare in the park. #abflood URL	Other Useful Information
RT @Cmdr_Hadfield: The flooding and flow into the Coral Sea at Gladstone, Australia - visible from the Space Station. URL	Other Useful Information
#yycflood Sunday, June 23 St. Anthony Catholic Church 60th Anniversary Picnic CANCELLED; RETWEET if possible	Infrastructure and utilities
RT @rcosman: @WBrettWilson @WestJet Nice job/donation effort! Brett Wilson's garden party! #OMGP ever retweet gives $1 to the #abflood reco‚Ä¶	Donations and volunteering
So much damage happening all over the place from flood and wind, and I'm like There's not much to report here!. #highground #bigwet	Not applicable
@j_lefuzz Please visit @cityofcalgary Calgary.ca for the most up-to-date information. #yycflood	Caution and advice
10 choppers on scene today in @LarimerSheriff . Drawing down resources in @TownofEstesPark . Access opening up along Highway 7 #coflood	Infrastructure and utilities
Burning fossil fuels kills people RT @billmckibben On the heels of the record heat, 4 dead in Queensland's epic floods. URL	Affected individuals
#Latest #News Flooding May Force 100000 From West Canada Homes - ABC News: ABC NewsFlooding May Force 1... URL #BNews	Affected individuals
RT @reedtimmerTVN: LIFE THREATENING flash #flooding in Colorado Foothills including Colorado Springs, Fort Collins, and Boulder areas URL	Other Useful Information
A very busy day of crisis communications today in #yyc. Happy to be helping my city and neighbours though! #yycflood	Donations and volunteering
Love the Campmaster portable stove, here it is pumping out espressos despite no power #bigwet #finallymustinstallgas URL	Infrastructure and utilities
More pics from Maroochy Conservation Reserve #sunshinecoast #bigwet URL	Other Useful Information
RT @PaulHBeckwith: Reflections on Obama's climate change speech last week... #climate #climatechange #extremeweather #weather #abflood URL	Not applicable
RT @Cdn_Puck_Girl: #Saddledome flood waters now up to row 14.  #yycflood #CalgaryFlames URL	Infrastructure and utilities
NEWS #SavetheChildren opens Child Friendly Space at #Ipswich evacuation centre, responds to children's needs #qldfloods URL	Other Useful Information
Now there's bad flooding in #Alberta? Oh no... Thinking of my Western neighbours tonight! #floods	Sympathy and support
Floods hit two Australian states, thousands evacuated URL #climate #floods #Australia #Australiafloods	Affected individuals
RT @RednockGeog: ‚Äú@guardian: Colorado floods: rescuers rush to evacuate stranded communities:  URL yr12 world at risk	Donations and volunteering
Colorado floods: More than 500 still unaccounted for as 'devastating' rain looms - CNN International: NPRColor... URL	Affected individuals
RT @theqldpremier: UPDATE SCHOOL CLOSURES: An updated school closures list is available now at URL - PT #bigwet	Infrastructure and utilities
Great place to donate for #abflood  .@NeighbourLink  They give supplies to individuals, displaced charities &amp; First Nations #yycflood	Donations and volunteering
RT @autALERT: BREAKING #BIGWET  #CATASTROPHE ZONE DECLARED Jan29 2:30pm #TWEED &amp; #NORTHERN_RIVERS NEW SOUTH WALES 41,000 PPL CURRENT ...	Affected individuals
going to the @calstampeders game tonight?? check out how u can donate to support #Siksika &amp; #Morley URL #abflood	Donations and volunteering
Everyone, be careful URL #boulderflood	Caution and advice
Community Support Centres are open to help citizens and small businesses connect with essential services URL #yycflood	Donations and volunteering
Great day cleaning out basements and helping to get Calgary back on its feet after the flood... It's great to see... URL	Donations and volunteering
Flew home over as very water logged NSW. #BigWet #NSWFloods Amazing how much water is still covering Grafton	Infrastructure and utilities
RT @Sean_in_Calgary: At the Drop In Centre(4804 Ed. Tr. NE) they need socks, underwear, back packs, and of course toiletries! #yyc #yycflood	Donations and volunteering
RT @cityofcalgary: For a list of communities where mandatory evacuations are still in place visit: URL #yycflood	Affected individuals
Hundreds Unaccounted for in Colorado Floods [Video] - URL	Affected individuals
RT @buzzbishop: Saddledome flooded to row 10. Dressing rooms destroyed. #yyc #yycflood So, about that new rink?	Infrastructure and utilities
RT @DavidW2035: Climate science has already proved its worth URL #auspol #bigwet	Other Useful Information
@JarrodHoare Major flood crisis hits QLD, Australlia. I hope u &amp; ur family r safe!	Sympathy and support
RT @RobDavis_Wx: Since records began in 1879, #Calgary's NINE largest floods all occurred before 1934... until now. #yycflood	Other Useful Information
Toronto Mayor Rob Ford offers support to flooded Calgary: As residents and officials deal with the flooding th... URL	Sympathy and support
Good to be home. #nopower #yycflood	Other Useful Information
Australians clean up from floods, supplies dwindle: BRISBANE, Australia (AP) ‚Äî Military personnel headed to flood-ravaged northeast A...	Other Useful Information
Thousands Evacuated as Flooding Hits Eastern Australia - Bloomberg: Sydney Morning HeraldThousands Evacuated as ... URL	Caution and advice
#COFlood coverage continues on CH20 and live stream: URL	Caution and advice
RT @canadogreg: Must see flooding pic from High River, AB RT @NatashaChiam: RT @tracyohn: High River #abstorm #abflood URL	Infrastructure and utilities
RT @breakingstorm: 5 people confirmed dead in Colorado flooding, and 1,254 people unaccounted for statewide, official says - @NBCNews URL	Affected individuals
RT @justinforabite: I got to a #yycflood fundraiser in yyz, only to discover the heavy rain in TO had flooded the venue.  I like my irony a‚Ä¶	Donations and volunteering
4,500 homes damaged in #coflood ,200 businesses destroyed, about 500 with damage. Less than 400 people still missing. URL	Affected individuals
RT @Cmdr_Hadfield: Flooding in Maryborough, Australia - visible as we flew over Tuesday morning, 29 Jan. URL	Other Useful Information
For updates on additional evacuation points throughout Boulder County for #boulderflood visit URL	Caution and advice
Evacuee Sadie and her new best friend Cook enjoying the sunny #estespark day! #COPets #COFloodRelief URL	Other Useful Information
‚Äú@MelissaBuntcake: This is 287 and Dillon Rd... Cars submerged after road gives way URL #BoulderFlood‚Äù. Awful!	Infrastructure and utilities
ALBERTA FLOODING - Canmore Bragg Creek High River Floods Calgary 2013... URL	Infrastructure and utilities
RT @redcrosscanada: We are accepting financial donations to assist people affected by flooding in Alberta: URL #abflood	Donations and volunteering
PetAid Colorado is assisting at-risk animals during the #COflood disaster. For more info on what you can do to help: URL	Donations and volunteering
Note: CBC has prov shows as well PRT @poor_choices: Good on ya @RutherfordShow URL #yyc #abflood #yycflood	Other Useful Information
RT @afreedma: As Calgary copes w/ record flooding, studies point to increased risk of river flooding in warming world URL	Other Useful Information
RT @KDVR: LIVE NOW: Why #coflood is being called a 1 in 1,000-year flood from CSU Prof. Russ Schumacher. Watch: URL #c‚Ä¶	Other Useful Information
Colorado towns slowly reopen after floods cut residents off from homes: Officials gave early estimates of dama... URL	Infrastructure and utilities
Report help needed in Bowness: 403-288-8300. Dispatching volunteers &amp; equipment where needed. Volunteering? Go there first! :) #yycflood	Donations and volunteering
RT @660News: Reminder: Call 311 for flood-related calls only. Call  911 in case of emergency. #yyc #yycflood	Caution and advice
RT @ShePlaysLoud: Thinking about everyone in Queensland,affected by floods, #tornado damage&amp; extreme weather. My heart goes out to y ...	Sympathy and support
RT @KellySommariva: Here's a look inside Milliken courtesy @9NEWS viewer Briana. Stoplight at Hwy 60 and Hwy 257. #coflood URL	Not applicable
RT @BigEasyMike1981: @VP: VP Biden #COflood @whitehouse: URL great team VP handling national issues and President hand‚Ä¶	Other Useful Information
RT @612brisbane: IPSWICH: Flood prediction maps now online &amp; available at: URL #bigwet #qldfloods URL	Caution and advice
Qld #bigwet could put some dairy farmers out of business URL	Other Useful Information
RT @dawnstarau: Can someone please inform the QLD govt that 23Mb PDF files are entirely not awesome for disseminating flood zone informa ...	Not applicable
Someone needs to tell NBC they don't need to be camped in front of my.apartment still, as they.have been for 3 days #boulderflood #headsup	Other Useful Information
RT @jacktodd46: Why is it that we respond generously to disasters like the Alberta floods - but refuse to deal with the climate change that‚Ä¶	Sympathy and support
RT @tunez4hoons: Blackhawk helicopters over North #Bundaberg &amp; flooded #BurnettRiver during mandatory evacuations #QLDfloods #BigWet ...	Donations and volunteering
RT @cnieuwhof: Thank you @connexuschurch. Today we shared that we're giving $5000 to help with Calgary Flood Relief: URL	Donations and volunteering
RT @TxStormChasers: Scanner: Highway 66 going into Lyons is underwater from the west at the Diamond Shamrock. #cowx  #boulderflood	Infrastructure and utilities
Record major flooding continues at Bundaberg, further rises expected on Tuesday URL #qldfloods #bigwet	Caution and advice
RT @QldSES: WOW! RT @a1d077: Cleveland Point #bigwet URL	Other Useful Information
RT @geographile holy cow, Toronto, the flooding! URL #climate #flooding #Toronto #Canada	Not applicable
@LisaOstrikoff: RT @cityofcalgary: There is NO boil water advisory in effect. #yyc water quality good #yycflood Yet!	Caution and advice
@AusNewsNetwork Your mom's breaking #NEWMAN re #BIGWET #OSWALD I've visited homes TORN apart today There is a trail of distruction along‚Ä¶	Affected individuals
RT @vanOnselenP: PM says this is exactly the right time for resignations... QLD floods followed by the minister for emergency management ...	Other Useful Information
Denver Business - DBJ special report: Colorado's floods - Last week's heavy rains across parts of Colorado were ... URL	Other Useful Information
#mothernature has #PMS bad &amp; is extremely angry right now. QLD here has taken a spanking &amp; NSW #bigwet on the way. Stay safe people &amp; alert.	Other Useful Information
So my dad is the best. He had some free time so he headed to High River early this morning to help! #missionpossible #abflood	Donations and volunteering
#BIGWET WAIT We KNOW DAM CAPACITY IS 225% #NEWMAN SPEAKS OF 88% FIGURE? Is He saying  #wivenhoe Dam is at 12% from FULL #BNEFLOOD CAPACITY?	Other Useful Information
RT @EnviroAction: Colorado #fracking site featured in @gaslandmovie now under water thanks to biblical floods. URL	Infrastructure and utilities
RT @TripleMBrisbane: Want to know when the #BigWet will affect you? Sign up to Brisbane's Early Warning Alert Service:  URL ...	Caution and advice
If he wasn't already creepy before...RT @ampcalgary Poor poor Harvey the Hound. #yyc #yycflood #abflood #saddledome URL	Other Useful Information
CSNews: Country Singer @paulbrandt Lends A Hand After Alberta Floods URL	Donations and volunteering
RT @plumberlocal: *** IMPORTANT *** We are pumping out people's basements at no charge! Call 403 288 1111 #abfloods #yycfloods #Calgary #YYC	Donations and volunteering
FLOOD WARNING FOR THE DAWSON AND FITZROY RIVERS URL URL #bigwet  Issued at 8:34 am EST	Caution and advice
RT @Daorcey: Thank you for trying to unflood Calgary. Drawings like this hang in Emergency Ops Centre. #yycflood URL	Sympathy and support
RT @tedhenley: WHOA!?! Heavy erosion UNDER the pavement RT ‚Äè@FFWDWeekly 25th Ave. Erlton/Mission #yycflood URL	Infrastructure and utilities
this has been an emotionally exhausting last 4 days #boulderflood	Other Useful Information
‚Äú@KDVR: Woman killed in Larimer County flooding¬†identified URL Source: Daughter. #coflood	Affected individuals
The Big Picture: Colorado floods URL	Other Useful Information
HANDY list of contacts and numbers. Have a look and write down any that you may need. URL #bigwet #bnefloods	Caution and advice
RT @Mookalicious: This pic of an awesome firefighter in Mission needs to go viral.  Please share! #abflood URL	Donations and volunteering
RT @QPSmedia: Non-essential travel on the Sunshine Coast tomorrow morning should be cancelled. #bigwet	Caution and advice
RT @Jesse_Johnston: @660News @News1130radio Behind the scenes look at emergency ops centre. #yycflood #abflood URL	Other Useful Information
Qld to discuss flood funding with Ludwig: The Federal and Queensland governments are expected to get the ball ro... URL	Other Useful Information
An aerial view of the flood in North Bundy #bigwet #devastation (via URL URL	Other Useful Information
RT @FletJan: Alberta premier warns of downstream floods to come URL #AB #environment #flood #disaster #cdnpoli	Caution and advice
RT @Mookalicious: Ok Calgary, let's give this some RT love. It's awesome!! #abflood URL	Other Useful Information
Floods kill three, force 75000 from Calgary homes - URL	Affected individuals
Traffic lights out on Bundall Rd and Bermuda. Take care. #bigwet #goldcoast @612brisbane @abcgoldcoast	Infrastructure and utilities
How Bad Is the Toxic Legacy Left Behind From Colorado's Floods and Other Extreme Storms? | Alternet URL	Other Useful Information
Calgary can't catch a break... Flash flooding tonight.	Other Useful Information
‚ÄòMassive Flooding‚Äô In Colorado‚Äôs Boulder County URL	Caution and advice
RT @BoulderRelief: NEEDED: New towels, new blankets, new socks, dry shoes, packaged food for #BoulderFlood relief! Bring to 2850 Mapleton A‚Ä¶	Donations and volunteering
They said #DEATH! Likely death toll in Colorado floods rises to at least nine - Reuters URL #Follow	Affected individuals
Rainfall records swamped: AS towns and cities along Australia's eastern seaboard cope with flooding in the wake ... URL	Other Useful Information
Scores of swift water rescues and a man missing in SE Qld @abcnews at 6:30 #bigwet	Affected individuals
Alberta floods: How did it happen?  ...   URL via @weathernetwork	Other Useful Information
Good time to test out my new kite, while I have no power and water #bigwet #qldfloods #cabinfever	Affected individuals
@iwasmadetolaugh but there's floods in queensland now	Not applicable
RT @Richard_H: Just reading about the floods in Colorado - we've spent a fair bit of time there over the years, hope it stops raining soon ‚Ä¶	Sympathy and support
RT @StJohnAmbQld: RT @SESBrisbane Is your mobile phone fully charged? Do you have emergency numbers saved in it? #bigwet #qld #qldfloods	Other Useful Information
At least 350 people still missing in Colorado flooding; five dead - URL	Affected individuals
RT @sbaranski: This kid is awesome.  Adorable Superman Is Here To Save Alberta! URL via @huffpostalberta #ABflood #abl‚Ä¶	Other Useful Information
Stephen Ave E. absolutely no one here and nothing going on. #feellikeRickGrimes #yycflood #TheWalkingDead URL	Infrastructure and utilities
Have I got this right, people of QLD want the Govt to step in and help. Have they forgotten Tony Abbott opposed the last QLD Flood Levy	Donations and volunteering
RT @petsarefound: NEW LISTING: LOST Blue Burmese CAT, Glass House Mountains QLD #qldfloods URL via @PetsAreFound #bigwe ...	Affected individuals
Colorado flooding puts oil and gas wells underwater URL	Infrastructure and utilities
Feel for the people of QLD again hit by floods	Sympathy and support
RT @garretdoll: I'm sad - @cabelas #thornton #colorado #flood #coloradoflood #whollstoptherain URL	Sympathy and support
Qld premier launches flood appeal URL (Daily Telegraph) #news #sydney	Donations and volunteering
RT @fishnette Not going anywhere for a while in my hood. At Lakebriar off Linden, Twomile Creek. URL #coflood	Infrastructure and utilities
Lots of good comes out from this disaster... also some lessons. #abflood #abpoli #abparty URL via @edmontonjournal	Sympathy and support
Wow &gt;&gt; ‚Äú@GlobalCalgary: PHOTO: The damage inside the Saddledome:  URL #yycflood URL	Infrastructure and utilities
RT @CDPHE: #COFlood Boil water advisories still in place for Lyons, Mountain Meadow (Allenspark), and Firestone. #cohealth	Caution and advice
@tennewsqld #bigwet #bundaberg how awful for these residents not being able to see there homes yet	Sympathy and support
RT @GongshowGear: Thoughts and Prayers with all our friends in Calgary as they weather record floods - stay strong #alberta	Sympathy and support
URL For info on flood relief debit cards @Crackmacs #yycflood	Caution and advice
RT @BillBelsey: Please RT widely @nenshi - The City asks that Calgarians LIMIT WATER USE as much as possible. Thank you. #yyc #yycflood‚Äù	Caution and advice
RT @JohnFBruce: TONIGHT ... AFTER THE FLOOD - WE'LL BE JOINED BY INSURANCE COUNCIL OF AUSTRALIA CHIEF ROB WHELAN ON THE ISSUE OF COVERAG ...	Other Useful Information
RT @_JohnTaylor_: Fools are kayaking down Kedron Brook. @abcnews @612brisbane #bigwet URL	Affected individuals
CROCODILES have been spotted swimming through the streets of Rockhampton... URL #qldfloods	Other Useful Information
My heart &amp; prayers go out to all the people in #Colorado &amp; to any1 who has friends or family affected by the #coloradoflood	Sympathy and support
RT @Mookalicious: Great news. Here we go Calgary!! RT ‚Äú@cityofcalgary: .@nenshi langevin bridge is now open #yycflood‚Äù	Infrastructure and utilities
Of wtf, Queensland, your call centre doesn't help us the fuck out, why are we getting slammed with YOUR flood calls!?	Not applicable
RT @NavyBoy88: according to officials, Flooding in #yyc expected to reach 6 Ave, those not familiar with Calgary, that's roughly 1 km inlan‚Ä¶	Caution and advice
RT @cityofcalgary: .@nenshi remember blue bin pick up has been suspended across the city #yycflood	Infrastructure and utilities
History suggests it may take time for Ottawa to foot #abflood cleanup bill URL by @josh_wingrove	Not applicable
RT @Daorcey: Please share: #yyc water still very safe to drink, but please conserve URL #yycflood	Caution and advice
RT @HeritageFunds: #Heritage Education Funds Donates $10,000 to Canadian #Red #Cross #Alberta Flood Fund. Read more: URL	Donations and volunteering
RT @weathernetwork: RT @pahnita: Panorama of the city from Scotsman's hill. #yycflood URL	Other Useful Information
RT @alex_ruiz: Oh Calgary :( -- Before/After Downtown Calgary. 9th Ave SE at 4th St #yycflood  URL via @AlainDupere @wea‚Ä¶	Infrastructure and utilities
Severe flood submerges parts of Flames' arena: Two rivers converged on the western Canadian city of Calgary ov... URL	Infrastructure and utilities
So proud of my hometown. Mayor Nenshi asked for 600 volunteers to help clean up #abflood. 7000 showed up.	Donations and volunteering
So we had 45+ degree weather with bushfires last week and this week floods   This is Australia	Other Useful Information
Central: Insurance Council says Rocky flash flood clean-up can begin URL #qld	Caution and advice
RT @SarCharLand: Interested in continued updates on #oilandgas and #coflood? Visit URL or email info@coga.org - thanks #‚Ä¶	Donations and volunteering
RT @CUBoulder: SEEK HIGHER GROUND IMMEDIATELY: Wall of water coming down Boulder Canyon. Move away from Boulder Creek! #BoulderFlood	Caution and advice
@OKCStormWatcher  100 school children trapped by deadly Colorado floods are airlifted to safety after 2 days trapped URL	Affected individuals
Hyundai, Mazda and Ford offering support to victims of Colorado flooding - Autoblog URL	Donations and volunteering
RT @kathleenweare: CREB: Too Early to see impact of floods on resale stats #yycre #yyc #remax #calgary #highriver | @scoopit URL	Caution and advice
Hey @optus,,, no service in Boyne/Tannum Qld... Too wet and windy ?? #bigwet #flatmatestelstrabroadbandworking #howtocontactwifey??	Infrastructure and utilities
A bit full #Qldfloods #bigwet URL	Other Useful Information
RT @CgyCA: UPDATE: Erlton, Victoria Park, Cliff Bungalow and Inglewood added to #yyc evacuation order because of flooding. #abflood	Caution and advice
Our @Tide Loads of Hope truck is located at Loveland's Laundromat, 266 E 29th St Loveland, CO 80538: URL #COFloodRelief	Donations and volunteering
RT @yychelps: How to Organize Your Own Grassroots Clean-Up Team via @cityofcalgary URL So awesome!! #yychelps #yycflood ‚Ä¶	Donations and volunteering
RT @cityofcalgary: Please avoid downtown if you can tomorrow. There will be a number of road closures. #yycflood #yyc	Caution and advice
RT @ezralevant: Disgraceful @pembina fundraising e-mail exploits Calgary flood victims. To be clear: they're raising money for themselves, ‚Ä¶	Donations and volunteering
RT @Tehelmin: Colorado Floods Break Pipeline and Engulf Gas Wells URL #coflood #coloradoflood #environment #oil #gas #fl‚Ä¶	Infrastructure and utilities
RT @GrowKeithCounty: Nebraska braces for overflow from Colorado flooding URL	Other Useful Information
RT @CodyCrouch: Over Lyons. You can see the bridge at Stone Canyon Rd is gone. #CoFlood URL	Infrastructure and utilities
9NEWS special presentation - Colorado Floods: The Road Ahead is on now. WATCH LIVE:  URL #9NEWS #cofloods	Other Useful Information
RT @beltline_pres: . #beltline 13 #yycflood . inundation in Beltline Victoria Park . URL	Infrastructure and utilities
Flooding at Oxley creek, bureau says it's sitting at around 4 metres and rising. #bigwet @abcnews_qld URL	Other Useful Information
RT @tourismqld: Details on flood assistance for #Queensland small businesses in today's special edition of TEQ Industry News - URL ...	Caution and advice
RT @612brisbane: #QldFloods update: Bruce Hwy OPEN with caution at Kybong south of Gympie, at Midgee &amp; at Tiaro, at Chinaman Creek h ...	Caution and advice
RT @HOUBizJournal: Houston #energy companies impacted by the Colorado floods, find out how serious the damage: URL	Infrastructure and utilities
A shot of the tree on our roof taken from the neighbour's garden. #bigwet #bnestorm URL	Affected individuals
Twenty rescued as floods sweep northeast Australia URL	Affected individuals
RT @RGIII: Please pray my family in Colorado and all others impacted by the #boulderflood	Sympathy and support
Potential health problems during flooding URL KUSA - The flooding across large areas of Colorado can bring along a ...	Affected individuals
RT @CPACOLORADO: *UPDATE* Some Much-Needed Context on the Colorado Floods URL	Other Useful Information
Climate Change Blamed for Australia's Recent Extreme Heat and Flooding URL	Other Useful Information
RT @OKCStormWatcher: Emergency flood alerts issued for towns in Queensland, Australia; residents urged to get to higher ground - @SBSNew ...	Caution and advice
@DonnieWahlberg Queensland is experiencing some really bad floods, really feelin what you guys went thru in NY now #loveeternal	Sympathy and support
RT @YYCfirehydrant: @GlobalCalgary a local #Devon Fire Hydrant sent me this picture. Water is usually at least 15ft lower #abflood URL	Not applicable
RT @bifnaked: Support @redcrosscanada as they continue to assist those affected by flooding #AbFlood And Donate here: URL	Donations and volunteering
Colorado Floods: 172 Still Unaccounted For URL	Affected individuals
RT @DavidCurnowABC: Qld viewers, @mattwordsworth's moving piece on #Bundaberg #flood recovery is on @ABC730 straight after the news.	Other Useful Information
RT @SunNewsNetwork: Alberta Premier Alison Redford calls flooding ‚Äòabsolutely tragic‚Äô URL #yycflood #abflood #Abpoli	Other Useful Information
#leimo URL Major floods hammer northern Australia: People look at a boat th... URL @Leimo @crowealexand	Other Useful Information
‚Äú@Cmdr_Hadfield: Flooding in Maryborough, Australia - visible as we flew over Tuesday morning, 29 Jan. URL #fb	Other Useful Information
RT @denverpost: Reader photos of the Colorado flooding -  URL Send us yours - URL #cowx	Other Useful Information
My favorite lunch/picnic spot along the #Boulder Creek ... Is now a raging river :( #COFlood @ Central‚Ä¶ URL	Other Useful Information
Hearts &amp; thoughts with those impacted by flooding &amp; evacuations in Alberta. Be safe &amp; take care of one another!	Sympathy and support
Getting screeched in in Mission #yycflood   Fishin in condos URL	Other Useful Information
2Pac/ Nas under silt n mud.. Aww maan! Well FOTC kinda made it out on top. #mission #yycflood #TearsOfARapper URL	Sympathy and support
RT @AlbertaBarley: Alberta farms and ranches avoid catastrophe in floods via @calgaryherald. URL #abflood #yycflood #aba‚Ä¶	Infrastructure and utilities
No crossing enoggera creek on that side road The Gap #bigwet #brisbane #flood URL	Caution and advice
RT @rap_unzel: Taking advantage of #yycflood URL	Not applicable
RT @MikeSoron: More than 1200 missing or unaccounted for in Colorado's 1000-year flood. URL #coflood #climate	Affected individuals
Riverbend &amp; Douglasdale, I'm headed your way to report on #ABflood for @GlobalCalgary. Tweet to me. #yyc	Infrastructure and utilities
RT @Reuters: Eight confirmed dead, 1,600 homes destroyed in Colorado floods URL	Affected individuals
Dear weather gods - I'm not sure #Longmont is ready for the thunder and lightning and rain just yet. Maybe hold off another week or 2?	Other Useful Information
BOM UPDATE: Mary River at Gympie set to peak at 21m on Monday morning. A peak of 10m during monday, in to Tuesday for Maryborough #qldfloods	Other Useful Information
RT @That1972Bloke: be prepared #BNE the winds are coming! It's blowing a #gale at #Maroochydore. #staysafe #bigwet	Caution and advice
RT @TrulyRedDeer: #RedDeer please share with everyone! #AbFlood #RedDeerGives RT, RT, RT :) URL	Donations and volunteering
RT @BrockJays: I want to send out my love and thoughts to everyone in QLD effected by the floods!! Be safe and look after your families! ...	Sympathy and support
RT @abcnews: Arveen Singh sends in this photo of a tree crushing a Forest Lake house in Brisbane. Take care out in the #bigwet URL ...	Other Useful Information
How You Can Help With The Devastating Floods In Colorado URL	Donations and volunteering
Not living in an evacuation are? That's a good thing. #yycflood	Other Useful Information
RT @TerryMassey: If we put up a swear jar around Taylor Field we'd pay for Alberta flood relief real quick. #FamilyAtmosphereReally #Riders	Donations and volunteering
#AWWA offers support and resources to flooded communities in Colorado. URL #coflood	Donations and volunteering
RT @C95: Good news! The water is receding and C-Train rides will be a lot more fun now. #YYCflood  URL	Infrastructure and utilities
RT @thekitchwitch @MadGreens @AnthonysPizza @BWWings #longmontflood . Thank you for your generous support of victims of #COflood.	Donations and volunteering
RT @BoulderFlood: Please pardon the inconvenience of my incontinence. I tried to hold it in but every hundred years or so... #boulderflood	Not applicable
Evac order only for affected areas or entire neighborhood (eg mission at 19 ave)?  @calgarypolice #yycflood map URL	Caution and advice
RT @DisasterTechLab: OK, the decison has been made. We're sending a core team to Boulder to provide Internet access and comms. #coflood #bo‚Ä¶	Donations and volunteering
BOM update: 02/16:46 EST Flood Warning Summary (QLD) URL	Caution and advice
RT @kriskross: Stampede cancels concert series . All t-shirt sales of 'Hell or High Water' should go to High Level. #abflood #yyc URL	Donations and volunteering
RT@PeterDoherty7: NSW: Take ex tropical cyclone Oswald seriously. He is one angry system #bigwet #NSW #sun7	Caution and advice
The flooding in Calgary right now....unreal. And it all travels east, so fuck.	Other Useful Information
RT @Avitusparta: Flooding and #Fracking in Colorado: Double Disaster URL via @rollingstone	Other Useful Information
#Colorado flooding kills two. @ryanparkerdp  URL ‚Ä¶	Affected individuals
NoCo will keep drawing national attention for all that it has going for it and come out stronger #coflood URL via	Sympathy and support
RT @ejo60: Meteorologic explanation of the Colorado floods which are related to atmospheric blocking, meaning that pressure‚Ä¶ URL	Other Useful Information
RT @vailresorts: Vail Resorts gives $100K &amp; $1 per #EpicPass sold to @RedCross relief efforts in #Colorado #COflood URL	Donations and volunteering
‚Äú@denvertowns: Boulder Flooding: Deadly High Waters In Northern Colorado Force Evacuations, Cause Mudslides: URL Crazy!	Affected individuals
RT @Rhiannon: Want to help? The @CalgaryDropIn needs transit tickets/passes and donations: URL #yycflood #abflood #yych‚Ä¶	Donations and volunteering
#News Floodwaters expected to peak in Ipswich at 6pm tonight. #BigWet	Caution and advice
Colorado flooding leaves 3 people dead  URL	Affected individuals
Queensland Floods ‚Äì Optus Network Update - 6AM (SingTel - Singapore Telecommunications Limited): ... URL #Science #News	Caution and advice
RT @QldSES: RT @QPSmedia: Major delays on every train line this morning. Commuters should have alternative plan. #bigwet URL ...	Infrastructure and utilities
At 5:13, the newly appointed Associate Minister of Regional Recovery and Reconstruction. Province pledges 1 billion to #abflood relief. #yyc	Donations and volunteering
Annual Magazine Subscription Discounted to support QLD flood disaster appeal - don't miss out on making a difference URL	Donations and volunteering
@BoulderOEM public info hours now 7 a.m to 9 p.m as situation transitions to long term recovery URL #Boulderflood	Caution and advice
News: 3 more oil spills from flooding found in Colorado - Denver Post URL	Infrastructure and utilities
The Walking Dead - Calgary AB ‚Äú@tvchick13: Wow. Just, wow. #yyc #abflood Photo courtesy J Dowd. URL	Other Useful Information
RT @cnnbrk: At least three deaths have been reported in Colorado flooding; more victims are feared. URL	Affected individuals
RT @Calgaryism: Keep Calm Stampede is On. We survive and prosper. #calgarystrong #calgaryflood #abflood URL	Sympathy and support
Canada: floods engulf downtown Calgary - euronews: euronewsCanada: floods engulf downtown CalgaryeuronewsFlash... URL	Infrastructure and utilities
Wivenhoe Dam is Qld's most important &amp; most dangerous piece of public infrastructure. @abcnews @612brisbane #bigwet URL	Infrastructure and utilities
#QLD Floods: Bundaberg - More than 2,000 properties affected. Nth Bundaberg about to be isolated - leave now if safe. @QPDmedia reports.	Caution and advice
RT @RobertHoge: Two #Brisbane CityCats heading for safe harbour to ride out the #bigwet URL	Other Useful Information
Speaker says they're working on getting Jamestown mail routed to Boulder.  #coflood	Infrastructure and utilities
DTN Taiwan: Taiwanese man on working holiday in Australia dies in flood: Taipei, Jan. 30 (CNA) A Taiwanese man o... URL	Affected individuals
RT @QPublicServant: Amidst the awful flooding of the last week in Qld, there r moments to raise a smile &amp; this is one URL ...	Sympathy and support
RT @Metro_Nolais: Flyover into downtown off Memorial closed, downtown could be hit bad #yycflood	Caution and advice
RT @BBCWorld: Australian state of #Queensland on alert for more tornadoes &amp; #floods - VIDEO URL	Caution and advice
VP Joe Biden: If government shuts down, FEMA will still deliver aid  URL via @denverpost @finleybruce #coflood	Donations and volunteering
#BIGWET GRIDLOCK ON ROADS #GRAFTON #NSW RECORD #NSWFLOOD JUST GET OUT NOW GO TO #SOUTH_GRAFTON HIGH SCHOOL IF YOU CAN OR SEEK HIGH GROUND	Caution and advice
All Calgary Red Arrow trips are on schedule. If you choose to cancel or change your trip, you may do so without charge. #yycflood #yyc	Other Useful Information
.@Premier_Redford: This is nothing like we've ever seen before &amp; will take enormous marshalling of resources #abflood	Infrastructure and utilities
RT @WellMinded: Monday Matters- Pets in Colorado Flooding URL via @RascalandRocco	Other Useful Information
#yycflood #DeerRun URL	Not applicable
RT @thetodayshow: .@TheQldPremier LIVE on the TODAY show now #qldfloods	Other Useful Information
RT @green_peace: PHOTOS: Flooding in Colorado sparks concern about flooded oil and gas tanks URL	Infrastructure and utilities
RT @Nishnabi: Alberta gas leak continues as extreme flooding prevents shutdown URL	Infrastructure and utilities
Stay away from fallen powerlines, warn others and call Triple Zero (000) or 13 16 70 to report them #bigwet	Caution and advice
RT @YoungCons: Harry Reid blames global warming for the Colorado floods. I guess there had never been a flood before we started driving car‚Ä¶	Other Useful Information
SNL calculates REIT exposure to Colorado floods URL $FSP $COR $IRT $RLJ	Other Useful Information
RT @WWF_Australia: Unique image of the QLD flood plumes from @Cmdr_Hadfield on Int. Space Station, our thoughts are with those affected  ...	Other Useful Information
RT @gardencatlady: Australia floods:Entire towns lie submerged under 4 FEET of sea foam along east coast (Photos) URL v ...	Other Useful Information
RT @globeandmail: Why you need to develop a business continuity plan URL #abflood	Caution and advice
RT @YYCFlood: Hippos almost escape @calgaryzoo during #abflood URL #yyc	Other Useful Information
RT @KellySommariva: Streets buckling like taffy. Viewer pic from Lee Hill Dr. and Lefthand Canyon Dr. #coflood #boulderflood URL	Infrastructure and utilities
#Jamestown resident says things are disappearing from lumberyards around town. Worried about more looters. They will come. #boulderflood	Affected individuals
RT @denverpost: Colorado floods relief: How to help victims, those affected URL #coflood	Donations and volunteering
queensland flood area URL	Other Useful Information
Strict new rules for homeowners in flood-prone areas. Do you agree with the ban? Vote in our poll URL #ableg #abflood	Caution and advice
Flooding in Queensland now disaster of  'epic proportions'   URL	Caution and advice
Flooding may force 100,000 from west Canada homes - URL	Affected individuals
Builders and soldiers hustle to reconnect #Colorado towns after flooding URL	Donations and volunteering
RT @paygeers_t: You hear about flooding all the time but it's surreal when it's happening at home #yycflood #prayforyyc	Other Useful Information
Australian state of Queensland hit by deadly flooding - BBC News: BBC NewsAustralian state of Queensland hit by ... URL	Other Useful Information
RT @dailycamera: Per @BoulderOEM, 245 customers in Boulder County still without power #boulderflood	Infrastructure and utilities
RT @BreakfastNews: RT @abcnews As ex-cyclone Oswald brings flood chaos to Queensland, follow our live coverage: URL	Other Useful Information
What The? Friday - This week, another good reason not to drive through or play in flood waters #wtfriday #bigwet URL	Affected individuals
Video: Evacuated Calgarians say flooding is worst they've seen | Watch the video - Yahoo! News Canada URL	Other Useful Information
Colorado floods threaten more homes as another feared dead - video URL	Affected individuals
#2030NOW People losing homes in Colorado didn't have flood insurance because they had never experienced #floods. #climatechange	Other Useful Information
Saturdays game against the Okotoks Erratic has been cancelled because of flooding in southern Alberta. No make up date at this time.	Caution and advice
RT @AlexWilliamson8: So QLD is flooding &amp; half the Collingwood side is on cocaine. No surprises in todays headlines.	Other Useful Information
#BIGWET UPDATE #BUNDABERG Many areas inundated. MAYOR: Burnett River at 8.2m rising 10cm/hr. Currently 350 ppl @ evacuation ctr's #qldfloods	Affected individuals
Amen. #boulderflood #hope #love URL	Sympathy and support
RT @ryanlanclos: Monitor #boulderflood #COwx on #Esri Disaster Response Program public information map URL	Other Useful Information
RT @909SeaFM: Mayor Tom Tate to open Community Recovery Centre to help residents affected by #bigwet, at Broadbeach this morning. #news  ...	Donations and volunteering
Live coverage: SE Qld on flood alert - ABC Online: URL coverage: SE Qld on flood alertABC... URL	Caution and advice
RT @QPSmedia: Disaster situation declared for Brisbane and includes areas of the Brisbane City and Redlands Council areas #bigwet	Caution and advice
Queensland is flooding AGAIN? Seriously, Queensland, this is a concern.	Other Useful Information
Monday Matters- Pets in Colorado Flooding URL via @RascalandRocco	Affected individuals
RT @Cmdr_Hadfield: The flooding and flow into the Coral Sea at Gladstone, Australia - visible from the Space Station. URL	Other Useful Information
Our thoughts are with so many of our friends and family affected by the floods in Colorado. Lets pray that all... URL	Sympathy and support
Colorado floods: Over 500 unaccounted for URL	Affected individuals
Work has begun on US 36 between Lyons and Estes Park, for restricted access information read more here URL #boulderflood	Infrastructure and utilities
Pray for the certain parts in Colorado that are affected by the #coflood	Sympathy and support
RT @7NewsBrisbane: #Logan is experiencing worst floods since 1974 - expected to peak at 9pm #bigwet #qldfloods	Infrastructure and utilities
can't stop watching the devastation in Calgary, Canmore and Medicine Hat - my hometown. Stay safe and help your neighbours #yycflood #medhat	Sympathy and support
RT @classyawards: Help @TeamRubicon help those affected by the #COflood donate here: URL  #veterans #militarymonday	Donations and volunteering
Kiwi trapped by Queensland floods - New Zealand Herald - via @summly URL	Affected individuals
RT @GlobalCalgary: GALLERY: Incredible photos of flooding around southern Alberta, inc. Canmore, Bragg Creek, Chain Lakes: URL	Not applicable
RT @joefryer: Latest #coflood stats from state officials: 584 unaccounted for (234 in Boulder Co, 350 in Larimer Co); 1750 evacuated by Nat‚Ä¶	Affected individuals
RT @cityofcalgary: South Fish Creek Recreation Complex reception centre is Full. #yyc #yycflood	Donations and volunteering
RT @ahuntre: Colorado floods: Over 500 unaccounted for as 'devastating' rain looms URL	Affected individuals
@IFreakSelena Colorado Floods Victims Urged 'Get Out Now': Rescuers will not return for families who refuse to evacuate...  @Ericccxminaj	Caution and advice
RT @calgaryjournal: City of Red Deer declares state of emergency: URL #abflood #abstorm #yqf	Caution and advice
RT @ironsider: Qld flooding.., here comes Tony Abbott..#bigwet2 URL	Other Useful Information
#bigwet Brisbane River walkway from Victoria Bridge, just before flood peak. URL	Infrastructure and utilities
RT @runningbloggers: Alberta Floods URL via @truenorthrunner	Not applicable
RT @femaregion8: If it's not safe for you, it's not safe for your pets.  Take them with you. #COpets #COflood	Caution and advice
Landsat Images Show Devastation Caused by Colorado Floods. URL #GIS #Imagery @NASA @USGS	Infrastructure and utilities
@Emma_J_Mc Hi Emma,wld love to speak to you for a story i'm doing for @triplejhack on the QLD Floods - can u follow me so I can DM you?	Other Useful Information
RT @GrumansDeli: We couldn't resist.  Thanks for helping get us out of this pickle @nenshi #yycflood #yyc #yycpickle URL	Sympathy and support
RT @AnnastaciaMP: The Queensland Flood Appeal 2013 has been launched. Please donate by visiting URL or contacting 1800  ...	Donations and volunteering
RT @starstodd: Phones are still open for the #COFloodRelief fundraiser!1-877-667-6727. URL	Donations and volunteering
RT @YourAnonNews: Oil spilled into Colorado waters exceeds 25,000 gallons: URL #coflood URL	Infrastructure and utilities
Watching the news coverage of the QLD floods #besafe everyone in the affected areas	Sympathy and support
RT @CDPHE: #COFlood water can contain sewage. Wash cleanup clothes separate from uncontaminated laundry. URL	Caution and advice
#SuryaRay #Surya Australia floods: 'We will get through this,' says Queensland Premier - Telegraph.co.... URL @suryaray	Other Useful Information
Access to Stradbroke Island cut for second day in a row - all ferries in and out suspended #strandbroke #Bigwet #QLDFlood @abcnews	Infrastructure and utilities
RT @5280Magazine: Our thoughts are with Colorado flooding victims. Share why you love CO on Instagram with #5280is20. #coloradoflood #risea‚Ä¶	Sympathy and support
BURNETT HEADS - REMAIN INDOORS - Tornadoes / Waterspouts in your region NOW #qld #qldfloods #bigwet	Caution and advice
RT @MapleLeafs: Our thoughts are with the @NHLFlames and everyone in Alberta affected by the #yycflood.	Sympathy and support
RT @iainilich: Despite #yycflood mayhem, @Shawhelp repair guy arrived on time to replace flaky PVR. Thanks!	Not applicable
OODA Loop: West Canada flooding forces 100,000 to flee homes | URL	Affected individuals
Got to love a good flood and tornado this time of year #Queensland #Brisbane	Other Useful Information
RT @WSPAAustralia: Queensland man saves platypus lost after floods URL  #qldfloods #2013	Affected individuals
RT @Cmdr_Hadfield: The flooding and flow into the Coral Sea at Gladstone, Australia - visible from the Space Station. URL	Other Useful Information
#Colorado braces for more heavy rain, devastating floods URL	Caution and advice
During severe weather, you may need to provide first aid while waiting on emergency services - have a first aid kit handy #1staid4 #bigwet	Caution and advice
RT @CBCCalgary: Medicine Hat plans to close the Trans-Canada Bridge as of 1900MT/2100ET.  #abflood #yyc #	Infrastructure and utilities
ALERT @Telstra on #fb: cable washout in #kingaroy area impacting landline, broadband &amp; mobile services across CQ &amp; NQ @cbemergency #bigwet	Infrastructure and utilities
Please check our blog for the latest in course openings and closings.  Many courses will reopen this week #ABflood URL	Infrastructure and utilities
RT @heenanblaikie: Our Calgary office remains closed due to the recent flooding that occurred in Alberta. For updates, visit: URL	Infrastructure and utilities
The windows are shaking at home, the wind is crazy!! And it's getting worse - #GoldCoast #bigwet	Infrastructure and utilities
RT @DopeMarcJames: Quite devastating. Please stay safe to everyone affected by the flood in Calgary. #CalgaryStrong URL	Sympathy and support
RT @BoulderOEM: Want to help? We are coordinating volunteers and donations through URL Thanks everyone!! #boulderflood	Donations and volunteering
RT @9NEWS: Update: boulder co us army rescues 60 people in 2 hours from Jamestown and Big Elk Meadow. More 2 come #coflood via @abolton9n‚Ä¶	Affected individuals
RT @DenverChannel: #COflood update in @LarimerCounty - Looking to use smaller aircraft for rescues in tight areas - Chuck Russell, Incident‚Ä¶	Affected individuals
Calgary Flood May be Canada's Most Expensive Flood in History URL via @wunderground	Other Useful Information
RT @RiverCafeYYC: We hope to be back open July 25th! Still lots of summer left to enjoy our patio! #yycflood #localfood URL	Infrastructure and utilities
@TheEllenShow  #CanYouHelpAlberta? #Devastation #OnlyPartOfIt #BigCatsAreInCourthouseJail URL #yyc #abflood	Not applicable
Awesome news. RT@ABTransComm Crews hard work pays off #Hwy1 opens 2 lanes near Canmore. Way to go! #ABFlood #abroads @BanffNP	Infrastructure and utilities
RT @QPSmedia: Keep up-to-date with the 2 Severe Weather Warnings current for Qld. #bigwet #tornado URL	Caution and advice
RT @MrHillCountry: Y'all keep Colorado, New Mexico &amp; Arizona in your thoughts &amp; prayers.  The floods are horrendous!  Pray the rain... URL	Sympathy and support
RT @trigger_sam: If ur  heart goes out to people that's involved with floods in Australia and the fire in brazil plz retweet let them no ...	Sympathy and support
RT @GlobalCalgary: A famous face showed up to help Calgary flood victims... #yycflood #yychelps URL	Donations and volunteering
RT @PedroChizo: Feel very sad for QLD. Bigger flood than 2011 which was the biggest flood ever, only 2 years ago. How strong are Queensl ...	Sympathy and support
RT @ABCNews24: Graham Quirk: High winds are predicted for #Brisbane between 2pm and 8pm tonight #QLDfloods	Caution and advice
RT @SnarkySteff: Had the wrong photo credit for that amazing fireman in the flood relief pic. It was @SUNLyleAspinall. #yycflood URL	Not applicable
RT @virginmobilecan: Members! Text REDCROSS or ROUGE to 30333 to donate $5 from your phone bill to help support Alberta flood relief effort‚Ä¶	Donations and volunteering
RT @weathernetwork: RT: Residents of #HighRiver AB asked to evacuate immediately. Severe and rapid flooding occurring. #abstorm #abflood	Affected individuals
RT @QPSmedia: Expect another 6 hours of rain in Brisbane. Flash flooding and dangerous conditions continue. #bigwet	Caution and advice
er‚Ä¶ what happened to ‚Äúif it‚Äôs flooded, forget it?‚Äù @QPSmedia RT @9NewsGoldCoast: Cops undercover #BIGWET Currumbin URL	Other Useful Information
RT @cityofcalgary: For mandatory evacuation information including locations and maps check here regularly: URL #yycflood	Caution and advice
RT @MinisterJono: The Calgary Police posted a thank you to all Calgarians. Retweet if you agree we should be thanking them #yycflood URL	Sympathy and support
They come from home to help.. #boulderflood URL	Donations and volunteering
RT @DamienGillis: Stunning new aerial pics of #coloradoflood #fracking damage. Citizens call for moratorium URL @gasland‚Ä¶	Infrastructure and utilities
Alberta flood zone development was a mistake, former MLA says ¬ªURL #FollowME	Other Useful Information
RT @QPSmedia: #bigwet Latest BoM FLOOD WARNINGS for coastal rivers and adjacent inlands catchments from Rocky to NSW. URL	Caution and advice
RT @MMcInerney89: Apparently areas around Coffs Harbour are expecting about 400-500mm tomorrow. #bigwet	Caution and advice
RT @tishaschuller: .@RedCrossDenver briefing on #coflood: Need to raise at least $5M.  Join us here URL #COGAResponds	Donations and volunteering
RT @MyBrownNewfies: Late night post. Helping Pets in the Colorado Flooding. #COFlood #BoulderFlood URL	Donations and volunteering
RT @sarahoffin: Photo by Erin Mielzynski: Canmore roads washed away #cougarcreek dangerously close to homes #globalyyc #abflood URL	Infrastructure and utilities
#ausopen fans, #climatechange does not 'ADVANTAGE YOU', just ask those soaked by the #qldfloods. @ANZ_AU are #OUTOFORDER for funding #coal	Not applicable
RT @sbaranski: .@Premier_Redford &amp; @pmharper pledge coordinated response to flooding  URL #ableg #ABflood #cdnpoli	Donations and volunteering
RT @QLDOnline: Up to 14 luxury yachts &amp; houseboats have been washed ashore in the Whitsundays #qld #tcoswald #bigwet	Other Useful Information
bfp Live Interactive Coverage: Flooding in Colorado: Stay on top of the latest videos and social media coverag... URL	Caution and advice
Flooding forces evacuation of downtown Calgary, Canada URL	Affected individuals
RT @dailycamera: Fundraising effort to Rebuild Jamestown launched in #Boulder County. #Boulderflood URL via @JoeCarmen‚Ä¶	Donations and volunteering
Has work been affected by Queensland &amp; NSW floods? Read ‚ÄòNatural Disasters‚Äô info for workplaces URL via @fairwork_gov_au	Other Useful Information
RT @B105Brisbane: BREAKING NEWS: A tornado has just hit Mooloolaba on the Sunshine Coast. More to come. #BigWet #QldFloods #Newsfeed	Caution and advice
RT @girlclumsy: Superb work by the @brisbanetimes team today on #bigwet ( @marissa_sc @bkjabour @CameronAtfield ). Live feed here: URL ...	Other Useful Information
Even Romney knew it was wrong to try and get political mileage out of Hurricane Sandy. Tony Abbott is shameless #bigwet #auspol	Other Useful Information
Leaving Boulder on Hwy 128. 72 is closed. Coal Creek Canyon closed. #boulderflood URL	Infrastructure and utilities
calgary flooding again.. you have got to be kidding me	Affected individuals
@cityofcalgary @CalgaryPolice @CalgaryFire #yycflood Hope yyc Fire Department and EMS requested larger twitter traffic limit 4 future emrgnc	Caution and advice
RT @jamescallsen: Eat local. Drink local. Shop local. #yyc #yycflood	Sympathy and support
RT @PaulaTrotter: Oh my gosh! My sister just sent me this pic of MacLeod at 9th Ave SE. Insane. #yycflood #downtownyyc #abflood URL	Other Useful Information
RT @Crackmacs: Bowness Park. Not much left #yyc #yycflood #abflood URL	Infrastructure and utilities
RT @ampcalgary: TRAFFIC: The ramp from SB Deerfoot to WB Glenmore is open #yycflood	Caution and advice
RT @KrisArvi21: #WeAreCalgary ‚Äú@blackpumahat: ‚Äú@ampcalgary: Who else needs to see a pic like this today? :) #calgarystrong #yycflood URL	Sympathy and support
VOLUNTEERS: Clean Up in Longmont 9am to 5pm! Meeting @ Twin Peaks Mall parking lot across from Schlotsky‚Äôs: URL #Coflood	Donations and volunteering
RT @HuffingtonPost: Colorado makes massive pet friendly rescue effort after flooding URL	Other Useful Information
.RT @CUBoulderPolice: #BREAKING: Raw sewage flowing from pipe north of Space Sciences (East CU Campus) near footpaths. Avoid area. #COflood	Other Useful Information
RT @schmutzie: Did you know that flood insurance doesn't exist in Canada? Text REDCROSS to 30333 to donate $5 in support of #ABfloods #yycf‚Ä¶	Donations and volunteering
RT @banff_town: Lake Minnewanka dam has not failed. Pls see latest #banff info URL #abflood	Infrastructure and utilities
#PMAANZNews Heartbreak for growers URL #freshproduce #bigwet #qldfloods	Other Useful Information
Pouring ‚òî-Put on comfy stuff, stay inside and let those saving our communities do their jobs unobstructed. #coflood URL	Not applicable
Colorado floods: 7 dead, hundreds missing, 1,500 houses destroyed URL	Affected individuals
RT @SEQincidents: Report of Fire Services Incident Swiftwater Vehicle rollover in floodwater Gympie Woolooga Road Widgee #bigwet	Infrastructure and utilities
Finally got the community services crews out helping in Mission. #ABflood Crews available, simply contact me.	Donations and volunteering
RT @AmandaAbate: Water gushing through Gold Coast hinterland, threatening shops #bigwet @7NewsBrisbane URL	Other Useful Information
Asia Top News: Australia Floods Cast Pall Over Wesfarmers Outlook URL (via CNBC Asia)	Other Useful Information
Three killed in Queensland floods - Irish Times URL	Affected individuals
29/10:52 EST Flood Warning - Logan-Albert (QLD)  URL	Caution and advice
RT @QPSmedia: WARRILL VIEW: The Cunningham Hway is closed due to flooding. #qldtraffic #bigwet	Infrastructure and utilities
RT @jianghomeshi: Our colleagues at @CBCCalgary are hosting an all-day fundraiser for #ABFlood relief. Info to help out if you can: URL	Donations and volunteering
Thoughts and prayers to all those affected by the floods &amp; tornados in Queenland,Australia!! #sendinglight	Sympathy and support
Sleepless in #brisbane. Battening down the hatches #qldfloods #cycloneoswald	Affected individuals
One day in Australia it's fires another its floods.	Other Useful Information
A couple days to rest and now back covering #coflood aftermath. Headed to #Larimerflood area to get latest at evacuee meeting tonight	Other Useful Information
RT @patstaron: When this is all said and done, nobody in #YYC should be going to Queensland Liquor ever again. #NoClass #ABflood URL	Other Useful Information
RT @CBSDenver: RT @CBS4Mark: The Big Thompson River in Milliken. The bridge is closed and debris keeps piling up. #coflood @JodiCBS4 URL	Infrastructure and utilities
RT @ChadBrownlee: To all those hotels, stores, and businesses in Alberta that have raised their prices during the flood; you're greed sicke‚Ä¶	Other Useful Information
RT @femaregion8: Mold is the scourge of flood cleanup. This 8-pg brochure can truly help: URL  #COflood	Caution and advice
RT @BrentToderian: The new normal with #ClimateChange: You're going to get wet. Frequency/intensity of storms. v.@aurbanist. #yycflood ht‚Ä¶	Not applicable
MT @CleanWaterCO1: #Colorado now tracking 10 #OilGas #spills in #COFlood zone #CoPolitics #fracking URL @AFPcolorado	Infrastructure and utilities
A shout-out to our emergency services for their amazing efforts so far. QLD loves you! @QPSmedia @QldFire @QldAmbulance @QldSES #bigwet #qld	Donations and volunteering
FLOOD #brisbane #bigwet URL	Other Useful Information
@sunriseon7 I would like to volunteer to assist with the clean up of the QLD floods but dont know who 2 contact about this.. #sun7	Donations and volunteering
At least 4 killd 500 unaccountd 4 as floodwatr inundates Colorado URL #flooding #neighbors #park #thinking	Affected individuals
RT @jeffruhlepp: @JayOnrait @tsnotoole $1 donation to #abflood relief by @WBrettWilson for every #OMGP used up to $50k!! Please RT!	Donations and volunteering
Seven confirmed dead, 1,500 homes destroyed in Colorado floods URL	Affected individuals
RT @KyleBakx: MT @CBCEyeopener: Our big news: we're turning our Stampede Breakfast into an all-day block party and #abflood fundraiser. Sta‚Ä¶	Donations and volunteering
@ednaqonz are you still snowing? because meanwhile in Australia we are having tornadoes and a lot of flooding	Other Useful Information
RT @DenverChannel: #COFlood update: Storm Mountain given additional access through Bobcat Ridge Natural Area &amp; Power Line Trail @LarimerShe‚Ä¶	Infrastructure and utilities
RT @abcnews: Breaking: Flood maps for Brisbane River are now available URL #bigwet	Caution and advice
RT @CBSEveningNews: The Univ. of Colorado Boulder will be closed today and tomorrow due to massive flooding in the area that has killed 2 (‚Ä¶	Other Useful Information
Wonderful photo ‚Äú@clasicmac: Love this pic!!! Police keeping our streets safe overnight. #yycflood #abflood URL	Sympathy and support
RT @JessMyers95: I seriously can't believe the images I'm seeing from the flooding in Colorado #staysafe	Sympathy and support
165mm in the 24 hrs to 3pm at #mountcrosby with more to come. Gusts feel less powerful and less frequent #bigwet @612brisbane	Caution and advice
Channel 9 Qld have a reporter covering the floods called @joeldry. How insensitive. #bigwet #qldfloods #laughteristhebestmedicine	Not applicable
UPDATE: #YYC flood evacuation areas #abflood URL	Caution and advice
RT @TELUS: RT @CalgaryPolice: Please evacuate the following areas of #yyc: URL #yycflood Please RT	Caution and advice
@NewsTalk4BC mayor of Scenic Rim trapped at Moogerah Dam by flood waters #bigwet URL	Affected individuals
RT @Cmdr_Hadfield: Hello Australia! Last night I I stayed up late to take a few photos of the flooding in the Northeast, which I'll be p ...	Other Useful Information
RT @cycloneupdate: 6:20PM EST Police: REPORTS OF ANOTHER TORNADO AT BURNETT HEADS. RESIDENTS REMAIN INSIDE. #bigwet #tornado	Caution and advice
RT @cityofcalgary: Due to rising water levels the lower deck of Centre Street bridge has been closed. Be careful #yycflood	Infrastructure and utilities
Knowledge is Power. Brisbane Basketball Inc. much better prepared for possible flooding in the coming days #bigwet URL	Sympathy and support
RT @QueensBands1905: At 3pm, we will be busking downtown to help the @redcrosscanada #abflood relief. Show your support or donate online! h‚Ä¶	Donations and volunteering
RT @LaurieOakes: Lib fundraising on back of Qld flood disaster as a devastating cyclone bears down will not earn  Tony Abbott any credit ...	Other Useful Information
Where the hell is my brother? RT @BoulderFlood: Thank you CU Lacrosse team for volunteering! @CULax URL #boulderflood	Donations and volunteering
RT @GlobalParker: Wow...‚Äú@GlennStreet: Saddledome is flooded, below the light is a ramp to drive down to arena floor. #YYC #yycflood URL	Infrastructure and utilities
RT @LaurieOakes: Lib fundraising on back of Qld flood disaster as a devastating cyclone bears down will not earn  Tony Abbott any credit ...	Donations and volunteering
RT @AusNewsNetwork: #nda #abnn - [REPEAT] FULL #bigwet #qldfloods and #nswfloods etc #tweetline found at @autALERT or by searching (top  ...	Other Useful Information
RT @rsinghphoto: Everyone should boycott @TravelodgeCa hotels! #yycgreedy #abflood URL	Not applicable
Can't even imagine how brutal the flood is in Calgary	Sympathy and support
Animal Rescue - Pet Shop - Colorado Flooding - Help Animals Now URL	Donations and volunteering
RT @PeterDoherty7: Looks like the BOM radar is either down or blown away #bigwet #ausopen URL	Infrastructure and utilities
News: Flooding hits eastern Australia URL	Other Useful Information
Nature Sends a Message: Massive Flooding in Calgary.: The media makes no mention of human caus... URL #wellness #yoga	Other Useful Information
Everybody Keep @DJWhizlam &amp;The Residents Of Colorado In Your Prayers! The Weather There Is Crazy &amp; It has Me VERY Concerned! #ColoradoFlood	Sympathy and support
RT @Cmdr_Hadfield: Floods are an unbridled misery. My heartfelt thoughts and wishes for a swift recovery to those battling the Alberta high‚Ä¶	Sympathy and support
RT @AP: Focus shifts from airlifts to trying to find hundreds still unaccounted for after Colorado floods: URL -CJ	Affected individuals
RT @QldSES: @surfqld warn: Keep off eroded sand dunes as there is a danger of collapse. Be safe! #bigwet #beachsafety	Caution and advice
MT @SUNRenatoGandia: Zoo animals needed to be moved out of the zoo, some in place: not gone to jail as said earlier city #yycflood	Other Useful Information
RT @GlobalCalgary: ON SCENE: Power outage in #Banff, Lake Louise - @DollJayme reports. URL #yycflood #abflood	Infrastructure and utilities
Bringing it Home: Impact of floods ripples to Aspen URL #aspen #colorado	Other Useful Information
Cleaning up McLeod Trail #yycflood #Erlton #trafficproblems URL	Donations and volunteering
Flash floods in Colorado URL via @YahooNews	Other Useful Information
My regards go out to all the people who have been affected by the tragic weather my thoughts are with you all #bigwet @7NewsBrisbane	Sympathy and support
RT @AngelLazyChef: Superior #cowx flooding, farm spewing into adjacent creek. Yes, that all was dry farmland. #colorado URL	Other Useful Information
#Breaking: Jamestown, Colorado, is under mandatory evacuation order due to flash flooding - @dailycamera URL	Caution and advice
On the bright side though, the apartment has never been cleaner #boulderflood	Not applicable
i get all the donations and stuff to the #yyc flooding but majority of the people in Calgary who are affected are pretty well off	Donations and volunteering
It is uplifting to see how community can come together in times of need. #abflood #abstrong @nenshi kudos for helping all see the positive.	Sympathy and support
RT @PetersDriveIn: #yycflood #yyc Anyone in uniform - meal today only (Wed) is free as well! Thks for your efforts - people appreciate!! üëçP‚Ä¶	Donations and volunteering
RT @passantino: Video: Severe flooding hits near Univ. of Colorado at Boulder URL	Other Useful Information
RT @QPSmedia: Disaster situation declared for Brisbane and includes areas of the Brisbane City and Redlands Council areas #bigwet	Caution and advice
RT @AustralianNews: Queensland records first flood death, as statewide catastrophe declared - Brisbane Times URL	Affected individuals
Is the big brother house okay? #QldFloods	Other Useful Information
RT @jennyk9923: Colorado floods URL	Other Useful Information
Calgary floods spotlight cities' costly failure to plan for climate change URL	Not applicable
Hundreds still unaccounted for in deadly Colorado #floods - URL	Affected individuals
RT @WestJet: Thank you to @redcrosscanada for leading #abflood relief efforts. We'd like to offer a donation of $25,000 to assist your work.	Donations and volunteering
RT @carlyraejepsen: So sad to hear about the floods in Calgary and that the show was cancelled. I'll be back soon! Stay safe everyone! Xox	Sympathy and support
RT @cityofcalgary: There is NO boil water advisory in place. Our water treatment plans are uncomprimised and quality remains high #yycflood	Infrastructure and utilities
Good morning! I've got the latest on record flooding in Alberta during the morning news run, tune in at 7, 8 and 11 for details. - Paul	Not applicable
RT @BreakfastNews: Video: Ipswich mayor Paul Pisasale blasts Insurance Council 'fool' Rob Whelan over @Lateline interview on Qld floods  ...	Other Useful Information
Ok there's huge flooding in Qld??! I'm only hearing this via twitter. Next stop - ABC News	Other Useful Information
‚Äú@YourAnonNews: State now tracking 10 oil and gas spills in Colorado flood zones URL #COflood‚Äù#NoFracking	Infrastructure and utilities
#yycflood be sure when you are ready for re building you call companies that have a biz license URL	Caution and advice
we all in Australia we have had bush fires flooding in all 2 weeks and still going	Other Useful Information
RT @sunshineglen: This new satellite image shows the sheer size of the system moving across Queensland right now. #bigwet URL ...	Other Useful Information
Fires / floods / cyclones - Happy 'Australia Day' Aussies.	Other Useful Information
RT @511Alberta: #Hwy36 is closed northbound at the town of #Vauxhall and southbound at Secondary #hwy530. #abflood #ABroads	Infrastructure and utilities
Crazy Flooding in Boulder, Colorado URL	Other Useful Information
3 dead, dozens trapped in Australia floods URL	Affected individuals
RT @autALERT: #bigwet #qldfloods #nswfloods Just, so it is; CLEAR MT = #modified_tweet Our network #abnn does # for referencing &amp; se ...	Other Useful Information
RT @Kacyyy: @9NEWS our new front yard pond #boulderflood URL	Other Useful Information
Nebraska braces for overflow from Colorado flooding URL	Other Useful Information
RT @CalgaryPolice: Clarifying a rumour for #yyc. There are NO zoo animals being sheltered at the Courts. #yycflood	Other Useful Information
RT @QPSmedia: EMERGENCY ALERT - Biloela. People in low-lying areas of town should move to higher ground or the Civic Centre. #bigwet	Caution and advice
Queensland braces for flooding: The Australian state of Queensland is on alert for flooding and more tornadoes i... URL	Caution and advice
Urgent need for #volunteers and #drivers this afternoon.  #abflood #Siksika #Morley  #Stoney_Nakoda URL	Donations and volunteering
The State Govt has ordered SEQ Water to release water from WIvenhoe to reassure residents. URL #bigwet	Other Useful Information
RT @lilliemedia: Radio Responds To Historic Colorado Flooding | URL URL via @allaccess	Other Useful Information
CGU customers affected by the QLD and NSW storms can contact our 24-hour claims team on 13 24 80. We hope residents stay safe #bigwet	Donations and volunteering
RT @KWCH12: One person dead after flash flooding in Colorado: Days of heavy rains caused flash flooding in Colorado's Boul... URL	Affected individuals
#Julia #Gillard goes to show support to flood victims and gets #flamed and when she defends herself casually, flamed. #doyourbest #Australia	Sympathy and support
Lol Alberta flood 2013	Not applicable
New look at the St Vrain in #Longmont via @Dougherty7NEWS Look how high river is flowing at Hover/3rd. URL	Other Useful Information
RT @EvanKerns: If your bored, check out the trend #boulderflood, some crazy pictures.	Other Useful Information
RT @boulderweekly: #COFlood first responders eat free at the Smashburger's food truck. Niwot High School, 8789 Niwot Road. Today &amp; tomorrow‚Ä¶	Donations and volunteering
RT @dawn_com: Military called in as deadly floods batter Australia URL	Caution and advice
RT @allisonjones_cp: Momo news! Cat is safe (so is owner) after watery escape from truck in #yycflood: URL By @ploriggio‚Ä¶	Affected individuals
@IFreakSelena Many Missing Now Accounted For In Colorado Flooding: Rescuers have reached some of the remote areas affec...  @Ericccxminaj	Affected individuals
RT @sunriseon7: Qld Health confirms every patient from #Bundaberg Hospital will be airlifted to Brisbane #sun7 #bigwet #qldfloods URL ...	Affected individuals
URL Colorado floods  #trending #topics URL	Other Useful Information
Officials: Some #Boulder roads will be closed for weeks, months, longer. #Boulderflood URL via @JoeCarmenRubino	Infrastructure and utilities
History repeating itself? Source: Wikipedia the flood occurred on Sunday, 27 January 1974, during the Australia Day weekend. #TheBigWet	Other Useful Information
Telstra phone services cut at Rockhampton, Cairns, Gladstone, Mt Isa, Mareeba, Townsville. 000 coverage is also down in these areas #bigwet	Infrastructure and utilities
Floods kill 3, 75,000 forced from Calgary homes URL | AP #news	Affected individuals
My poor pool is full of muddy water again! üò•#bigwet#frustrated URL	Affected individuals
RT @TxStormChasers: RT @odog: Sleeping above ground tonight. Stay safe #boulderflood #boulder URL #cowx	Sympathy and support
RT @QPSmedia: POLICE CALLING FOR IMMEDIATE EVACUATION OF BUNDABERG NORTH. #bigwet	Caution and advice
RT @RedCrossAU: We‚Äôve launched an appeal for people affected by #qldfloods: URL Please support &amp; RT. #bigwet	Donations and volunteering
Yousa punk bitch if you don't know about Boulder. This flood don't know what it's dealin' wit! #boulderflood	Sympathy and support
A friend who lost everything, but zip lined her chickens and dogs out of destroyed home #boulderflood URL	Affected individuals
27/17:22 EST Flood Warning - Burrum River (QLD) URL	Caution and advice
RT @GVolesky: #USArmy Heroic efforts of Fort Carson MedEvac company save lives in Colorado floods URL @FortCarsonArmy @F‚Ä¶	Sympathy and support
Whoohoo! Thankyou @Energex power back on Kiels Mtn 4559. Time for a cuppa. #bigwet	Infrastructure and utilities
Ashgrove Flooding Australia Day Weekend 2013.wmv: URL via @YouTube	Other Useful Information
@YMCA_Calgary Glad to see all partners at South Fish Creek Recreation Association coming together to welcome evacuees. #yycflood #staysafe	Donations and volunteering
RT @SenBennetCO Suffered damage from #coflood? Register w/ FEMA for disaster assistance URL or call 1-800-621-FEMA Plz RT	Caution and advice
Aptly named Creek St under water in the #Brisbane CBD #bigwet URL	Other Useful Information
For information on how to help those affected by the floods, go to URL URL #coflood	Donations and volunteering
RT @globeandmail: Video: Alberta flood victims need relief, not politics: Mulcair URL	Other Useful Information
#COFLOOD Affected Pets Need Your Help!  URL via @amyshojai	Other Useful Information
RT @abcwidebay: Sunshine Coast Airport has been closed today. All flights in and out are cancelled due to strong winds #QLD #bigwet	Infrastructure and utilities
Current centre of Ex-TC Oswald is 40km WNW of Cooktown and moving in a SSE direction at about 18 kilometres per hour. #bigwet #qld	Caution and advice
Only when it buckets down. Bardon backyard creek appears #bigwet URL	Affected individuals
Welcome to Boulderlandia. Climb to safety. #boulderflood URL	Other Useful Information
RT @truthmashup: 3 more oil spills from flooding found in Colorado. URL #oilspill #oil #uspoli #p2	Infrastructure and utilities
Rescue helicopters resume flights - so great to see evacuees landing at the airport in @bouldercolorado! #COflood	Affected individuals
My bedroom roof Goddess. Hope everyone is safe tonight #sweetdreams #bigwet #brisbane #storm URL	Sympathy and support
A Devastating Before/After Comparison of the Colorado Floods, Captured by Satellite URL	Infrastructure and utilities
RT @DougInBoulder: ALERT: Wall of water coming down Logan Mill RIGHT NOW! Seek higher ground IMMEDIATELY! #boulderflood #cowx /scanner/1125‚Ä¶	Caution and advice
RT @etuqldnt: ETU members @ Stanwell Power Station keeping the lights on in difficult conditions URL #qldpol #bigwet #q ...	Infrastructure and utilities
RT @Accu_Jesse: Cloud seeding did NOT cause Colorado Flooding #coflood #goodtoknow URL	Other Useful Information
DTN USA: Number of missing in Colorado floods drops; property loss soars: The number of people unaccounted for... URL	Affected individuals
Gayndah QLD is getting no help from government. I am driving supplies up there if anyone can help donate anything.#bigwet #thebigwet	Donations and volunteering
RT @AbbGeography: VIDEO - Hundreds still missing in Colorado #flooding URL	Affected individuals
RT @BrunoMars: Calgary I just heard the saddledome is closed after the flood. I can't play my show but I will come back soon - hold on to y‚Ä¶	Infrastructure and utilities
#HighRiver residents are homeless and @grcrcmppolice worries about abandoned firearms? &gt; URL #HellToPay #abflood	Affected individuals
Army on standby amid #Qld flood crisis URL #tornados #Brisbane	Donations and volunteering
RT @BoulderFlood: Salvation Army needs toiletries &amp; socks for #BoulderFlood victims! They can provide blankets/sheets right now. Go to 1701‚Ä¶	Donations and volunteering
Warwick: Crews have begun restoring power to properties in Warwick .customers are being re-connected where it is safe to do so #bigwet	Infrastructure and utilities
RT @W00PIGS000IE: BREAKING:  Experts have determined Colorado Flooding was caused by tears of Badger fans, FEMA is sending trucks loaded w/‚Ä¶	Other Useful Information
RT @MollyHendrickso: We're headed to #Milliken today. We'll have continuous coverage starting at noon w the latest on the #coflood. #7newsN‚Ä¶	Other Useful Information
At least 1 dead in Colo. flooding: Severe flooding in Jamestown in Colorado's Boulder County killed one person... URL	Affected individuals
RT @camerondickqld: Roofing iron, Logan Road, Holland Park. QPS on scene. #qldfloods #bigwet URL	Infrastructure and utilities
RT @queensu: Queen's to accommodate incoming students from flooded areas in Alberta: Many students in flood-ravaged parts o... URL	Donations and volunteering
RT @MapleLeafs: Our thoughts are with the @NHLFlames and everyone in Alberta affected by the #yycflood.	Sympathy and support
Strangers open homes to Calgary flood victims on Kijiji: As shocking photos of the damage done by flooding in... URL	Donations and volunteering
RT @Cosmic_Surfer: Colorado burns then floods but deniers still deny climate change URL	Other Useful Information
Australia: dramatic rescues amidst storms and flooding: Emergency services make some dramatic rescues and more t... URL	Affected individuals
Rescuers battle Australia floods URL	Other Useful Information
RT @australian: Brisbane braces for flood peak: HUNDREDS of homes in Ipswich have escaped inundation in Queensland's flood crisi... http ...	Infrastructure and utilities
Lots of resources to help residents with flood recovery efforts on our website. Visit URL #WaldoFlood, #COflood	Caution and advice
Wisma Putra Malaysian victim of Queensland floods yet to be confirmed URL	Affected individuals
RT @QPSmedia: #bigwet Latest BoM flood summary and warnings can be found at URL or QLDAlert URL	Caution and advice
RT @jfleck: Why the #coflood fracking freakout is misplaced - there's *all kinds* of bad shit in urban/suburban flood water: URL	Other Useful Information
#Presbyterian Disaster Assistance responds to the #Colorado flooding. Learn what you can do to help: URL	Donations and volunteering
RT @Greeblemonkey: The original of the photo that is floating everywhere for #boulderflood @brandash's photo URL	Other Useful Information
RT @tegangeorge: ‚Äú@cycloneupdate: Emergency flood alert for Callide Crk - residents to move to higher ground #bigwet #qld‚Äù	Caution and advice
RT @bebeasley: @markusoff: RT @lonnietaylor: The Ctrain tunnel coming into the core is underwater. #yycflood URL Oh wo‚Ä¶	Infrastructure and utilities
RT @KikkiPlanet: The Alberta Government's News Release &amp; pledge of $1 billion to aid in #yycflood clean-up &amp; rebuild: URL	Donations and volunteering
We're ready to have a good time whilst raising money to aid the #coloradoflood victims. Join us!  URL	Donations and volunteering
RT @EricHolthaus: This is nearly unfathomable: the Big Thompson River has spent nearly 60hrs at record levels. #boulderflood ongoing. URL	Other Useful Information
RT @MudArmyQLD: #MudArmy - Logan is FULL with Volunteers for this weekend but LOCKYER VALLEY needs you!  #BigCleanUp #BigWet URL ...	Donations and volunteering
RT @BradenLatam: The view inside a flooded basement in Sunnyside. U can see how high the water once was. #yyc #YYCFlood013 #yycflood URL	Infrastructure and utilities
Where are Malcolm Turnbull &amp; Joe Hockey while @TonyAbbottMHR is filling sand bags? I trust they're doing their bit. #Queensland #Flood	Other Useful Information
RT @LiseMerle: Never underestimate the power of Mother Nature. The TransCanada Highway at Canmore no longer exists. #abflood URL	Infrastructure and utilities
RT @7NewsBrisbane: Energex says they have repaired nearly 3000 fallen powerlines and will attend to a further 1100 today. #qldfloods #bigwet	Infrastructure and utilities
RT @zonca: The Condamine River about to go over the bridge in Warwick: #bigwet URL	Caution and advice
RT @CstShaw: I hear that @WBrettWilson is donating $1.00 for every RT of #OMGP to the #yycflood relief. Thanks Brett!	Donations and volunteering
RT @iamcodysangel_: R.I.P to those in Queensland who have died in the floodsüëºüåπ	Affected individuals
RT @TheHarperGov: My PMO working furiously tonight  to reveal the truth of Justin Trudeau's connection to southern Alberta flooding.	Not applicable
Stay safe everyone! #boulderflood	Sympathy and support
RT @DorrieF: ‚Äú@Mookalicious: This pic of an awesome firefighter in Mission needs to go viral.  Please share! #abflood URL	Other Useful Information
RT @abcnews: Follow our live blog for the latest on the flooding #bigwet. Brisbane River to peak at 11am, Bundaberg on Tue night URL ...	Caution and advice
Praying for the rain to stop in QLD. Everyone stay safe. #QLDFloods	Sympathy and support
RT @jianghomeshi: Canadian Red Cross has set up a direct way to help out re #Alberta floods. Donate here - URL #yycfloo‚Ä¶	Donations and volunteering
RT @JenTryon: One of many basements we saw this morning in Calgary. #yycfloods Here stories of return, tonight on Global URL	Infrastructure and utilities
Flooding kills one in Colorado -  BOULDER #county, Colo. ‚Äî Severe flooding in Jamestown in Colorado‚Äôs Boulder... URL	Affected individuals
RT @RedCrossAB: @UnitedWayCgy this is incredible. Thank you so much for the support, it is greatly appreciated! #calgarystrong #yycflood	Sympathy and support
@ABCFarNorth why do the ABC presenters continually refer to rain fall using inches? How long has Aust. been metric? Catch up time!#bigwet	Not applicable
Saved by any means possible: Stunning flooding images around Calgary, Alberta, as people are being saved any w... URL	Other Useful Information
Nenshi praises electrician volunteering w/ crews in Sunnyside. #abflood #yycflood #chlive	Donations and volunteering
RT @ryanbelleville: .@strombo We are doing a big comedy fundraiser for flood relief in Alberta tonight at the Gladstone hotel. Please RT ht‚Ä¶	Donations and volunteering
Proud to be playing this all star event in #Loveland, #Colorado to help those affected by the #CoFlood #Potcheen URL	Donations and volunteering
So Stupid! RT @TwitchyTeam 'Not smart': Life-threatening #BoulderFlood? Boulder college students go tubing [video] URL	Other Useful Information
I am about to fly from #yxe to #yyc. I will be curious to see how horrible the flooding looks from the air. Fingers crossed for #calgary.	Infrastructure and utilities
Sending our thoughts and prayers to those affected by the Colorado flooding	Sympathy and support
#yycflood reporters: when you come to the next pressr, cd ya bring some ibuprofen? Cluster of your competitors will pay all our dollars	Donations and volunteering
RT @RemaxRealtor: Skies are absolutely opening up again in Arvada and Broomfield.. Pouring rain, not good. #coflood	Other Useful Information
Lots of #abflood updates on our liveblog URL	Other Useful Information
About 100,000 people evacuated in southern Alberta. #ABflood	Affected individuals
Floods shut down Canada's oil capital, two killed says Reuters URL	Affected individuals
S/O to @CUBoulder, @dailycamera, and @bouldercounty for being on their game tonight. Thanks for the updates and alerts! #BoulderFlood	Caution and advice
RT @autALERT: #QLDFLOOD #queensland Premier Campbell Newman: ** PARENTS REMINDED TO KEEP CHILDREN AWAY FROM CREEKS and #STORM WATER DRAI ...	Caution and advice
RT @Channel9: QLD viewers: Premier Campbell Newman confirms parts of Ipswich &amp; Brisbane susceptible to flooding; LIVE News @ 9.30pm  ...	Caution and advice
RT @nzherald: The latest updates on Australia's floods: URL	Caution and advice
I dislike channel 7, but their coverage of the devastation in Laidley is commendable. Thank you for not just caring about the city #bigwet	Other Useful Information
Devastating to see this tragedy unfolding live on @7NewsBrisbane. Stay safe east coast friends, we are here for you! #nswfloods #QLDFloods	Sympathy and support
RT @CONG1860: 5 #NationalGuard helos &amp; crews from @wyoguard joining @CONG1860 and @USArmy #4thID in #COflood evacuation efforts today.	Donations and volunteering
Police: Latest road information, have a look at the State Highways and Motorways report #bigwet #qldtrafficDMR - Traffic &amp; Travel Informa...	Infrastructure and utilities
RT @QPSmedia: Confirmed tornado at BURNETT HEADS. Residents should REMAIN INDOORS. #bigwet	Caution and advice
RT @7NewsBrisbane: Disaster situation has been declared for #Brisbane, including Brisbane City and Redlands Council areas #bigwet #qldfloods	Caution and advice
RT @AlexWilliamson8: So QLD is flooding &amp; half the Collingwood side is on cocaine. No surprises in todays headlines.	Other Useful Information
Queensland braces for flooding: The Australian state of Queensland is on alert for flooding and more tornadoes i... URL	Caution and advice
Western Canada hit by heavy flooding: As many as 100,000 people have fled their homes as heavy floods wash awa... URL	Affected individuals
DTN Italy: Alberta braced for fresh flooding: More communities in the Canadian province of Alberta are on floo... URL	Caution and advice
I hope no weed plants were damaged. #boulderflood	Other Useful Information
This was on FB Gold Coast &amp; Tweed is currently on Tornado Watch!! #Crap #bigwet URL	Other Useful Information
RT @USATODAY: #BREAKING: Severe floods strike Colorado URL	Other Useful Information
Foam covers Currumbin Beach #bigwet #qldfloods #bigblow URL	Other Useful Information
The Marcellus Effect: Colorado Floods Break Pipeline and Engulf Gas Wells URL	Infrastructure and utilities
Hoping my love @maddy_shea and all other calgarians are staying safe #abflood #yycflood	Sympathy and support
RT @cwood: .@VisitEstesPark recovering impressively from #COflood. This weekend I stayed at the @StanleyHotel and ate at @TheGrubsteak &amp; @T‚Ä¶	Other Useful Information
@theqldpremier Ipswich water is rising to 15m - can expect 200+ properties affected. Worst area - Goodna. Evac centres are open #bigwet	Other Useful Information
RT @clubwah: Will people of Queensland remember Abbott didn't want a levy to help pay for the last floods/storms.? What will he pledge i ...	Other Useful Information
RT @CUBoulderPolice: #cuboulder campus will also be closed tomorrow (9/13) due to #boulderflood. #cowx	Infrastructure and utilities
RT @yycGael: ‚Äú@vote4terrywong: With @yycgael lady's @barbward4 and Maggie at @calgarydropin clean up #yycflood URL awes‚Ä¶	Donations and volunteering
More Spills Reported In Wattenberg Oil Patch Following Colorado Flooding URL via @HuffPostGreen -- @globol10 !!	Infrastructure and utilities
RT @MadelnCanada: Stay safe, Alberta. #abflood #yycflood	Sympathy and support
Bow River at the weir looking west. #yycflood #yyc #calgary URL	Other Useful Information
RT @Metro_Nolais: Water restrictions remain in place #yycflood	Caution and advice
RT @markusoff: Breanne Waggott catches a fish outside her home in Bridgeland, several blocks from river. #yycflood foraging. URL	Other Useful Information
Another woman missing and feared dead in Colorado floods URL	Affected individuals
Take an aerial tour of Colorado‚Äôs flooding:  URL	Infrastructure and utilities
His house was wrecked in the #BoulderFlood. So he decided to play his piano. (via @Upworthy) URL	Infrastructure and utilities
Seeing all these people affected by the floods is very sad. Thoughts r with them. #bigwet #qldfloods	Sympathy and support
Donations made to @RedCrossAB and @CalgaryHumane please do your part tweeps and assist #yyc #yycflood	Donations and volunteering
RT @BoulderFlood: Touching story from a #BoulderFlood Relief volunteer. This is what its all about: URL	Donations and volunteering
Lord Mayor Graham Quirk has announced that 50 skip bins will be placed around Brisbane for the disposal of spoiled food. #qldfloods	Other Useful Information
Bundaberg store owner affected by flooding: Thank God for insurance. Wouldn't be too sure about that. #readthefineprint #bigwet	Infrastructure and utilities
RT @australian: Man's body found in Lockyer Valley: THE death toll in Queensland's flood disaster is set to rise with police rep... http ...	Affected individuals
RT @LeftHandBrewing: Help us spread the word about #LongmontOktoberfest &amp; #COFlood relief! Share: URL	Donations and volunteering
The pictures of the flood in Calgary and Southern Alberta is just so heartbreaking! #abflood #heartbreaking #staysafe	Sympathy and support
His house was wrecked in the #BoulderFlood. So he decided to play his piano. (via @Upworthy) URL	Infrastructure and utilities
RT @ABPremierComms: .@Premier_Redford hugs an evacuated senior at the #yyc Fish Creek YMCA evacuation centre #abflood URL	Affected individuals
RT @aldjohnmar: Our first Emergency Shelter will be the Southland Leisure Centre. #yyc #yyccc #yycflood	Infrastructure and utilities
RT @YourAlberta: DEBIT CARD update: to register for #abflood evacuee relief cards, call @RedCrossAB at 1-866-696-6484, not 311. URL	Donations and volunteering
Flooding from extreme rainfall is a hazard for ON too. Emergency in #Alberta should be a call to get a 72 hour kit. Better to be prepared.	Caution and advice
With heavy rainfall, basement car parks can be flooded. If you live in a high rise with such a car park, please be aware. #bigwet	Caution and advice
@mitchell2906 You too!!! I'm stuck home in the #coloradoflood  Truck got stuck last night and roads flooded.  #funsunday lol	Other Useful Information
RT @2DayFMSydney: QUEENSLAND FLOODS: One man has died and there are fears for three others  #2DayFM  #newsfeed	Affected individuals
Water level monitor and chart #evergreenflood #coflood #jeffcoflood URL	Caution and advice
RT @NateInVegas: I'll donate $1 (up to $500) for every retweet this gets to help someone affected by the flood in #Calgary #Canmore #High R‚Ä¶	Donations and volunteering
@XcelEnergyCO reports most electric customers back on line, but 2000 gas customers still out, half in Boulder County. #coflood.	Infrastructure and utilities
Palmwoods police just called to say they can't reach my dad by road tonight. It's like an ocean out here. #bigwet	Other Useful Information
#Colorado Floods Leave #Hundreds Unaccounted For URL	Affected individuals
RT @NTNL17: Plenty of food and coffee for all our neighbours in need of relief. Please join us. #yycflood URL	Donations and volunteering
@EricFrancis where did she deliver them? #yycflood	Not applicable
RT @EmergencyAUS: Get Emergency AUS to have warnings sent straight to your mobile for free. #bigwet #QLDfloods #NSWfloods #Bundaberg htt ...	Caution and advice
Sheriff: 3rd person killed in Colorado flooding URL	Affected individuals
RT @FoothillsUW: Your support is desperately needed. Please help now. #COFLOOD #BOULDERFLOOD  #LONGMNOTFLOOD    URL	Donations and volunteering
How was your day? #okotoks #afterlight #loveyourneighbour #cleanup #abflood #flood #flood2013 #sotired URL	Sympathy and support
RT @AnjuRestaurant: Please spread the word. All flood workers and emergency crew come get a hot meal. #yycflood #feedthepeople	Donations and volunteering
RT @Agent350: Irony alert @KDVR: Oil spills now exceed 25,000 gallons due to Colorado¬†flooding URL	Other Useful Information
RT @sandra_harris: Climate catastrophes like the Alberta floods have the potential to shatter political careers URL via ‚Ä¶	Other Useful Information
Downtown Calgary evacuated as flooding takes turn for the worse URL	Affected individuals
‚Äú@denverpost: UPDATE: Federal aid begins to flow to flood ravaged Colorado URL #coflood‚Äù	Donations and volunteering
RT @longpre11: For #abflood relief efforts, I'll be donating $0.50 per new follower b/w now and 11pm MT to @RedCrossAB; $1 if ur from #YMM ‚Ä¶	Donations and volunteering
RT @GlobalParker: An up close look at the centre street bridge, flowing through lower deck. Courtesy: Alex Halat #yycflood URL	Infrastructure and utilities
RT @TwitterAU: Twitter accounts with news about floods in Queensland: @612Brisbane @QldSES @abcsouthqld @QLDOnline #qldfloods	Caution and advice
RT @bruce_arthur: Holy cow, Calgary. RT @CarrieTait: Downtown power could be out for months - it is a possibility. - Fire chief. #ABflood	Infrastructure and utilities
RT @CarlBalan: Terrible whats happening in Albta. Canada cares b/c dt Calgary is shut down but every year dozens of reserves flood in Manit‚Ä¶	Sympathy and support
Please check out opportunities to volunteer tomorrow (Friday) in Boulder and Longmont: URL #BoulderFlood	Donations and volunteering
HACKING @alkazaaan Deadly floods hits east Australia URL  HACKING @onoyra	Other Useful Information
Just found out my mum is trapped at home, no water, no power,  tree's down across roads out of her property near glasshouse mtns. #bigwet	Affected individuals
Hey employers in Canada (and the United States) you should take up a collection at your fine establishments to help with the flood relief	Donations and volunteering
VP Biden speaking with a #COflood survivor in Greeley (9/23) URL	Sympathy and support
RT @DenverChannel: PLEASE RT: New evac center at Silver Creek High School at 4901 Nelson Road in Longmont.#boulderflood -@dailycamera	Infrastructure and utilities
i360SLGov: FEMA Continues to Support Response to Colorado Flooding URL	Donations and volunteering
#Cricket9 if I wanted to watch the floods I'll look out the window , put the cricket on channel 9 QLD !	Other Useful Information
RT @ABC: Colorado Floods: Residents Unsure of What Home Will Look Like When They Return URL	Affected individuals
RT @NewsBreaker: BREAKING: Train stuck in flood water in Ontario, Canada; passengers stranded URL URL	Not applicable
Colorado Statewide rainfall from the #coflood published by @ColoradoClimate here; URL @FloodsOrg @FloodPolicyWonk	Other Useful Information
RT @harpoooon: I feel like nobody realized it was the first day of summer in Calgary #yycflood #notsummer	Other Useful Information
According to the automatic gauge in #Bundaberg the Burnett River has passed the Dec 2010 level of 7.92m.  Now at 8.1m and rising #bigwet	Caution and advice
Serious amounts of flooding and evacuations of several neighborhoods taking place throughout Calgary. URL	Affected individuals
Help Jonathan, Cailey &amp; The Doggie Depot recover from #boulderflood  URL via @gofundme	Affected individuals
RT @ohitseesha: yesterday in australia: fuck we are burning to the ground  today in australia: fuck we are flooding	Sympathy and support
RT @breakingstorm: 2nd death related to Colorado flooding reported - @9NEWS; for more: URL	Affected individuals
Flooded Colorado to get heavy rain: Flooding has stranded thousands, cut towns apart, ripped out roads andyE184Rhmgcrd6QaYI3FC	Other Useful Information
RT @CalgaryPolice: And also evacuate this area of Bowness. #yycflood 2/2 URL	Infrastructure and utilities
RT @AllHands: Video update from our #COflood team: URL #drivemuch #sunshinemakeslifebetter #volpower	Caution and advice
RT @Energex: Safety alert: Now more than 500 fallen powerlines reported in SEQ. Keep everyone well away and call us on 13 19 62. #bigwet	Infrastructure and utilities
RT @GoldCoastBureau: Foam washes through Justin Park on Burleigh headland #bigwet #bigblow #qldfloods URL	Other Useful Information
RT @ShopprsDrugMart: Donate your Shoppers Optimum Points at any SDM store to the Canadian Red Cross flood relief efforts in Alberta #abfloo‚Ä¶	Donations and volunteering
RT @whogivesaknit: I think the rain is coming.... #yyc #yycflood	Other Useful Information
RT @Simon_C_Ward: Eagle St pier has gone under again. Restaurants inundated. @9NewsBrisbane #bigwet URL	Affected individuals
RT @abcwidebay: You'll find a gallery of photos from across the Wide Bay here #Bargara #bigwet URL @abcnews	Other Useful Information
RT @COEmergency: .@FloodDSS: Summary of Federal Aid for Private Water Infrastructure. URL #coflood	Donations and volunteering
Right Wing Minister Claims Colorado Floods Due To Homosexuality And Abortion (AUDIO) URL	Not applicable
It's all starting to feel so sad. RT @CalgaryPolice: Aerial photo of flooding at Prince's Island Park. #yycflood URL	Infrastructure and utilities
Check out Colorado frack-site flooding - September 2013 URL #colorado #fracking #flood #wells #well #oil #gas #fracked	Infrastructure and utilities
RT @TheTonyRiley: @SESBrisbane: Another Brisbane City SES team heading out..#bigwet URL we are all thanful for the vo ...	Donations and volunteering
RT @SIartybartfast: You idiot. Qld and nth Australia has been flooding for millennia. NOTHING NEW. @Adam_Stott @TonyAbbottMHR #auspol	Other Useful Information
Twitter For First Response : Loyal2U - URL #KerryGeorge #abflood #yycflood	Caution and advice
RT @OWHnews: Colorado flooding: Have your friends and family been affected? Email @gaarder at nancy.gaarder@owh.com or call her at 444-1102.	Affected individuals
Are there any organizations in #yyc that can use volunteers right now for #yycflood? People show up and we'd love to refer them to you.	Donations and volunteering
RT @Cmdr_Hadfield: Floods are an unbridled misery. My heartfelt thoughts and wishes for a swift recovery to those battling the Alberta high‚Ä¶	Sympathy and support
Australia Flood Waters Begin to Recede  URL  (0:59) @youtube„Åï„Çì„Åã„Çâ	Caution and advice
Floods kill two, forces 75,000 from Calgary homes: Floods kill two, forces 75,000 from Calgary homes CALGARY,... URL	Affected individuals
Alberta awakes to more rain as flood crests near URL #yeg	Other Useful Information
MT @WayneDBJr Firefighters assist with Colorado floods URL #COflood ^CB	Donations and volunteering
#coloradoflood -Colorado floods: Over 500 unaccounted for URL	Affected individuals
RT @ConvoyofHope: If you live in #Colorado and would like to volunteer to help with our #CoFlood response. Please sign up here: URL	Donations and volunteering
RT @TheTimMcGraw: Thoughts, prayers and love to everyone affected by the flooding in Calgary.  Needed 2 postpone our show this week, but it‚Ä¶	Sympathy and support
LIVE NOW: Coverage of #qldfloods continues on @9NewsBrisbane.	Other Useful Information
Colorado floods: How to talk to kids and stay strong amid disaster URL	Caution and advice
CNN: Homes destroyed in Colorado floods: The skies have improved over Colorado, allowing some evacuated ... URL #news	Other Useful Information
RT @GloomyMushroom: Wow a mini tornado in Queensland and flooding. Can that now be declared as the unluckiest state in Australia now?	Other Useful Information
All my thoughts go out to the people back home in Australia struggling with floods, bushfires and other natural disasters. Be safe. xxx	Sympathy and support
RT @YahooNews: Flooding kills 3, forces 75,000 from Calgary homes: URL URL	Affected individuals
RT @Earls16thAve: Sending our love to Earls Tin Palace! Stay safe friends! #yycflood #earlstinpalace #repost URL	Sympathy and support
RT @RGIII: Please pray my family in Colorado and all others impacted by the #boulderflood	Sympathy and support
Did you know? Via @bouldercolorado: #Boulder is the #1 flash flood risk community in Colorado. #Boulderflood URL #COwx	Other Useful Information
Blue skies but still no power #bigwet #nopower	Infrastructure and utilities
RT @downtownboulder: We know you're all concerned about damage to #PearlStreetMall from the #boulderflood. We're happy to report that it wa‚Ä¶	Infrastructure and utilities
‚Äú@James_L_Bennett: Just found this pic on the SEQ flood update facebook page... nice work cows! #bigwet URL so good üêÆ	Other Useful Information
RT @5280Magazine: Our thoughts are with Colorado flooding victims. Share why you love CO on Instagram with #5280is20. #coloradoflood #risea‚Ä¶	Sympathy and support
Colorado Floods Damage Farms, Oil Wells, Roadways URL	Infrastructure and utilities
RT @Ascrazyasmyhair: Leaving Sterling, driving past Fort Morgan #coflood @9NEWS URL	Other Useful Information
RT @carlyraejepsen: So sad to hear about the floods in Calgary and that the show was cancelled. I'll be back soon! Stay safe everyone! Xox	Sympathy and support
RT @nenshi: The City of Calgary newsroom is also a good source for the latest releases about #yycflood URL	Caution and advice
Floods bring stress to an entire family, including kids. Here are tips to help kids who have been affected: URL #yycflood	Caution and advice
RT @dinnerwithjulie: Water definitely receding in Inglewood. Good news! #yycflood URL	Other Useful Information
@athleticone01 Very insensitive with all the flooding in Colorado.	Other Useful Information
Chococino waves @ Snapper #qldfloods URL	Affected individuals
RT @USATODAY: More than 500 people remain unaccounted for across Colorado after deadly, historic flooding: URL	Affected individuals
RT @buzzbishop: This Is NOT how you win friends. #wtf #yycflood MT @CalgaryParking: regular parking rates are in effect today.	Other Useful Information
RT @JT_KYOTE: Floods in beenleigh and eagleby #hometown #bigwet #brisbanefloods URL	Caution and advice
RT @claudlemire: The upside of tragedy, the many acts of kindness #yycflood #abflood URL	Sympathy and support
@ladygaga please rt to show your support to all those that have lost everything in #aus during the #qldfloods and #ausbushfires. #doinithard	Sympathy and support
At least 350 people still missing in Colorado flooding; five dead -  TweetTweetEmergency workers are undertaking... URL	Affected individuals
RT @B105LSA: Amazing photo of the rain - thanks to Jamie in Northgate for this one. #bigwet URL	Affected individuals
RT @LisaHerbertABC: HOLY COW!!! RT ‚Äú@QldSES Trampoline stuck in the top of power pole. Unbelievable #Bargara #bigwet URL	Caution and advice
RT @TheTimMcGraw: Thoughts, prayers and love to everyone affected by the flooding in Calgary.  Needed 2 postpone our show this week, but it‚Ä¶	Sympathy and support
RT @GlobalNational: Calgary Zoo announces animal deaths after flooding: URL #yycflood	Affected individuals
#NSWSES Units are on standby and ready to assist in the #bigwet &amp; #NSWFloods. Many units are already active... URL	Other Useful Information
Deadly flood waters rise in eastern Australia URL	Other Useful Information
RT @thegooglecar: At least one dead in Colorado flash flooding URL #Environment	Affected individuals
@CstShaw What is happening to the animals at the zoo? #yycflood	Affected individuals
Troops lend muscle to Queensland's flood recovery (ABC) URL	Other Useful Information
Video of Mayor Tom Tate holding media conference at 1.30pm to update on severe weather URL #bigwet #qldflood #qldfloods	Caution and advice
Red Cross Responding to Alberta Flooding URL	Donations and volunteering
RT @CIAwesome: ROAD CLOSURE: Many parts of Elbow Drive are under flood watch and are closed off. Stay away! Use alternate routes #abflood #‚Ä¶	Caution and advice
RT @sustainabilitst: Fracking Flooding in Colorado. The secret pollution that media isn't covering. URL	Other Useful Information
RT @dailycamera: VIDEO: Flooding at 28th St underpass in #Boulder tonight URL #boulderflood	Infrastructure and utilities
RT @brucemills: RT @anita_roe: Power outage #scarborough #redcliffe should be resolved by 10.30pm #energex. #bigwet	Infrastructure and utilities
INFOGRAPHIC: Colorado Flooding Impact Map @firechiefmag #firechief #wildfire URL	Other Useful Information
Drop-in has evacuated to: 4804 EdmTrail NE, need pillows and blankets!! @GlobalCalgary @CTVCalgary #yychelps #yycfloods	Donations and volunteering
Roads in northern Colorado reopen as floods recede URL	Infrastructure and utilities
RT @stevegrueber: Flooding west of #drumheller toward museum. #abflood @660news @calgaryherald @globalcalgary URL	Infrastructure and utilities
Please.God let the Waters Receed.in Colorado , and take those people out of bondage.man. #coloradoflood .	Sympathy and support
RT @nycjim: With sewage treatment disabled, no flush rules imposed in Colo. town. URL via @denverpost #coflood	Caution and advice
RT @JamieNiessen: 75,000 evacuated, only 1,500 in shelters. that's my calgary #yycflood	Affected individuals
RT @democracynow: Some 1,900 oil and natural gas wells have been shut down in #Colorado due to flooding, reports @JamesLPullen. URL	Infrastructure and utilities
RT @CarolMaeWY: Update: Is there a media blackout on the fracking flood disaster in Colorado? URL #COflood URL	Infrastructure and utilities
RT @femaregion8: If it's not safe for you, it's not safe for your pets.  Take them with you. #COpets #COflood	Caution and advice
RT @CBC_Carla: AMA tells me MOST people with flooded homes will not have insurance since flood insurance doesn't exist for homes in Canada #	Other Useful Information
RT @ToddGallant: More help from @canadianforces ... rolling down hwy QEII. Impressive sight. #calgary thanks you. #yycflood	Sympathy and support
RT @Stevesownacc: @SwannyDPM has been advised to stay away from the #qldfloods . The huge tin foil hat on his massive head attracts ligh ...	Caution and advice
Thank u @LeahRemini for tweeting how people can help the #ColoradoFlood victims.	Sympathy and support
Reports of Road Traffic Crash ‚ñ∂ Nr Keefton Rd Bruce Hwy Gympie URL #bigwet URL	Infrastructure and utilities
@chikom @chikom hey u okay? U in #calgary? Saw news abt #floods.	Sympathy and support
Expert: Colorado flooding - URL Expert: Colorado floodingDigitalJournal.comWATERLOO, ON, Se... URL	Other Useful Information
All beaches remain closed from Tannum Sands to Coolangatta. Stay out of the water. #bigwet	Infrastructure and utilities
RT @GlobalCalgary: We are live streaming a special Calgary edition of @GlobalNational right now - URL #yycflood #abflood	Other Useful Information
RT @nicollefagan: Rivalries aside, keep those affected by the #BoulderFlood in your thoughts and prayers. Hopefully no more lives are taken‚Ä¶	Sympathy and support
John Maynard Keynes would argue the #coloradoflood is stimulating the economy. #EconomicsFail	Other Useful Information
Sending good vibes to the people out their risking their lives in this storm! Cops, Fireman, EMTs, and pizza guys on scooters! #bigwet #QLD	Sympathy and support
Over 1200 people unaccounted for after huge Colorado flooding. Pray for them	Affected individuals
The folks in #Jamestown were told to evacuate, but the road is washed out and they can't: URL #boulderflood	Affected individuals
#PrayForColorado #ColoradoFlood URL	Sympathy and support
Alberta floods could increase chance of finding fossils  #radio #tech #news #rslink URL	Other Useful Information
RT @BelindaABC: Warrego Highway at #Chinchilla still closed - inspectors lookin gat the area today. @abcsouthqld #bigwet #news	Infrastructure and utilities
RT @aldjohnmar: Calgary, the time is coming we will need you...rest now, because we will call. #yyc #yyccc #yycflood	Sympathy and support
RT @SamaritansPurse: Volunteers began helping victims of the #COflood yesterday. We still need volunteers, you can sign up here: URL	Donations and volunteering
RT @WeFightForFair: Media release from this morning's press conference on our #qldfloods class action. We have a strong case, get on boa ...	Caution and advice
RT @QPSmedia: What The? Friday - This week, another good reason not to drive through or play in flood waters #wtfriday #bigwet URL ...	Other Useful Information
RT @BoulderOEM: City of #Boulder / Boulder County public info call center: 303-413-7730. Impacted residents can call for info. #Boulderflood	Donations and volunteering
RT @michaelstrahan: My thoughts and prayers go out to everyone in Colorado dealing with the floods and also to everyone in D.C at the Navy ‚Ä¶	Sympathy and support
RT @SquigglyRick: No, a nightmare bus. MT @7NewsBrisbane: Grey Wolf #Spider (we think) escorting young from floods in #Jandowae #bigwet  ...	Not applicable
‚Äú@CalgaryParking: @cityofcalgary you may park in any CPA surface lot or Centennial Parkade without charge tomorrow. #yycflood‚Äù	Caution and advice
Colorado flood death toll rises: The death toll from the historic flooding that hit Colorado last week rises to seven, as state offic...	Affected individuals
Pls RT 5:36 pm June 21 @LethbridgeCity: Whoop Up and Highway 3 remain open. #yql #abflood	Infrastructure and utilities
Colorado flooding leaves 3 people dead URL	Affected individuals
Ey... America. 19K Homes Damaged or Destroyed in Colorado Flooding, 5 Dead URL	Affected individuals
Story Bridge has been reopened. #bigwet	Infrastructure and utilities
RT @KyleTBBG: #abflood Medicine Hat is at the start of its share of the flooding.. Subscribe for updates.. URL	Caution and advice
RT @MichelleRempel: Pictures are not worth the risk to your person or to our emergency responders. Avoid the river. #yycflood	Caution and advice
RT @SensorsSystems: DigitalGlobe Takes a Close Look at Colorado Floods  URL	Other Useful Information
Native and non-native reptiles feeling the stress of Colorado floods URL	Other Useful Information
At least 18 oil spills resulted from Colorado flooding URL	Infrastructure and utilities
#qldfloods crossing my fingers for the poor people of Bundaberg, Ipswich and the other towns that are copping it worse than us	Sympathy and support
RT @Claudia_Imhoff: #BoulderFlood Large surge of water reported in Fourmile Creek passing Logan Mill @ 10:55 Residents down stream should c‚Ä¶	Caution and advice
#yycflood #abflood #yychelps twitter tip -- keep your posts to 130 char's or less so your important links get retweeted too!	Other Useful Information
RT @KDVR: Jake Jabs from @AmericanFurn donated $20,000 to @RedCrossDenver for #coflood victims this AM. URL URL	Donations and volunteering
Hang in there shade sail! #bigwet #crazyweather URL	Sympathy and support
Colorado Digs Out After 'Biblical' Flooding URL	Other Useful Information
Sirens blasting across outer #newcastle suburbs #bigwet #nswfloods #hunter Just going to check #stormwater drains in this break in rain. BRB	Affected individuals
@MAXgreenCalgary while I'm not on FB I still want to double up my donation. Adam - thanks for doing this. Please +$150. #yycflood #abflood	Donations and volunteering
More wet-weather pics. #bigwet #HerveyBay URL	Other Useful Information
RT @malenko10: Australia has always had bushfires and bad flooding since i can remember. No one mentioned climate change. 50 years of ex ...	Other Useful Information
RT @TELUS: RT @tgreenc: Free local, long distance &amp; text mess for evac'd @TELUS customers in #abflood limit calls to keep lines open for 1s‚Ä¶	Donations and volunteering
RT @SSFCRABBITOHS: We're thinking of all those affected by the #bigwet. Stay safe everybody.	Sympathy and support
Salina Residents Capture Wall Of Water On Video URL #boulderflood #COflood	Other Useful Information
A tribute to #Calgary #yyc #flooding #Okotoks  URL	Sympathy and support
RT @bpincott: Christ Church Elbow Park has food, massage,reflexology, chiropractors &amp; calm for volunteers &amp; responders. #yyccc #yycflood #y‚Ä¶	Donations and volunteering
cc @babrbi_twins #COpets RT @NinaSparano: #Coflood Evacuated dog runs to his owner waiting at the #RedCross URL	Donations and volunteering
Because we needed more rain... #yycflood #abflood #abweather	Other Useful Information
RT @SnowScribe: @jaredpolis and other U.S. congressmen call for hearing on flood-triggered #oil, #gas #spills #fracking #boulderflood URL	Other Useful Information
Nice republicans @denverpost: #CoFlood: Colorado National Guard flood work could be delayed by shutdown URL  #copolitics‚Äù	Caution and advice
Evacuation center for Boulderites YMCA of Boulder Valley, 2850 Mapleton Ave, Boulder, CO 80301 #boulderflood	Caution and advice
RT @guardianworld: First fire, now floods: Australia lashed by rains as tropical cyclone Oswald heads towards Sydney URL	Other Useful Information
There is still the potential for #tornado activity across SEQ. #bigwet	Caution and advice
RT @cityofcalgary: Please RT widely @nenshi - The City asks that Calgarians LIMIT WATER USE as much as possible. Thank you. #yyc #yycflood	Caution and advice
RT @BoulderRelief: Not in Colorado? Just $5 will buy dry socks, a flashlight, and batteries for a #BoulderFlood victim who needs help: URL	Donations and volunteering
RT @denverpost: People refusing to leave their Larimer County homes, only 100 rescued Tuesday URL #COFlood	Affected individuals
Probe opens way for Queensland floods class action - The Australian: Brisbane TimesProbe opens way for Queenslan... URL	Affected individuals
Photos: Flood water rises in Australia URL #news	Other Useful Information
RT @Pollytics: Qld coastal cities face a 1 in 100 year flood. Haven't had one of them for at least 3 years. But as you were - no climate ...	Caution and advice
RT @NateInVegas: I'll donate $1 (up to $500) for every retweet this gets to help someone affected by the flood in #Calgary #Canmore #High R‚Ä¶	Donations and volunteering
RT @fractivist: House Democrats call for hearing on oil, gas spills in Colorado floods  #ban #fracking URL	Other Useful Information
RT @QldFire: A big shout out to all QFRS staff &amp; volunteers who worked throughout the night helping their fellow #Qlders #bigwet #ql ...	Sympathy and support
RT @USRealityCheck: Floods, high winds batter NSW, Australia: NEW SOUTH WALES, Australia, Jan. 27 (UPI) --  Ex-tropical cyclone Oswa...  ...	Caution and advice
‚Äú@Noosaville: Boats along Gympie Terrace #Noosa river foreshore #bigwet URL Geez mate it's rough!	Affected individuals
RT @TheoFleury14: BREAKING: Water is up to row 10 at Saddledome. Dressing rooms completely submerged. #yycflood #NHL‚Äù	Infrastructure and utilities
Mandatory evacuations ordered in Calgary from flooding; 100,000 people may be affected URL	Affected individuals
RT @Cmdr_Hadfield: The flooding and flow into the Coral Sea at Gladstone, Australia - visible from the Space Station. URL	Other Useful Information
RT @markloiseau: Boulder's floodplain map URL #boulderflood	Other Useful Information
RT @jody_macpherson: Want to help out? A crowdsourced page of ways you can help Clean up Calgary URL #yyc #yycflood #ab‚Ä¶	Donations and volunteering
Back from the floods: Friday update on Colorado's recovery URL #news	Other Useful Information
RT @popingay: Feels strange being evacuated from the 33rd floor. Trust me, if the water gets there we're all screwed. #yyc #yycflood #abflo‚Ä¶	Affected individuals
RT @JGrivel: Disasters like this make you realize the importance of not taking things for granted. #heartbreaking #yycflood #abfloods	Sympathy and support
@HarveyNormanAU Can it make the #bigwet go away up here?	Other Useful Information
RT @BruceGrady: @QldSES members &amp; emergency crews working hard across #Qld helping their communities during the #bigwet &amp; #qldfl ...	Donations and volunteering
RT @Metro_Nolais: Two Calgary Transit tunnels damaged, no timeline for restoring downtown LRT #yycflood	Infrastructure and utilities
RT @ctvedmonton: Fire crews, Epcor staff and ETS buses heading to #yyc to help with cleanup efforts. #abflood #yycflood #yeg @CTVNews URL	Donations and volunteering
Thoughts those doing it tough in the Colorado floods	Other Useful Information
RT @FarmLead: Devastating. Eerily similar-looking to '97 MB flood RT @StephHansenFM: Arial view of High River, AB. Wow. #abflood URL	Infrastructure and utilities
RT @MikeNelson247: 2:30 AM Mike &amp; Anne still on the air! #BoulderFlood #7News #cowx #Denver URL	Other Useful Information
RT @msnbcDisrupt: Pres. Obama has declared a state of emergency in Colorado after record flooding. To find out how you can  help go to: htt‚Ä¶	Other Useful Information
RT @CUBoulder: SEEK HIGHER GROUND IMMEDIATELY: Wall of water coming down Boulder Canyon. Move away from Boulder Creek! #BoulderFlood	Caution and advice
RT @abcnews: Breaking: Flood maps for Brisbane River are now available URL #bigwet	Caution and advice
Looks like we'll be waiting a while for our power to be assessed! Or has it already been done? @4bc #bigwet #bnestorm URL	Infrastructure and utilities
RT @MHNMcCuaig: Latest pix of the flooded TC bridge construction berm-can't even tell it's there. #medhat #mhflood #abflood URL	Infrastructure and utilities
Australian Emergency Services Tackle Queensland Flooding #fire  URL	Donations and volunteering
George street #bundaberg. #bigwet URL	Infrastructure and utilities
Federal government ready to foot the bill for Alberta flooding damage: Canada's Immigration Minister Jason Ken... URL	Donations and volunteering
Breaking News: 4 more found alive and well after Colorado floods URL	Affected individuals
RT @drewryniewicz: Praying for the victims &amp; families of the #NavyYardShooting &amp; #Colorado floods.	Sympathy and support
RT @paulbrandt: Thanks for your generosity! Text REACH to 45678 to give $10 to @builditforward, proceeds to recovery for #abflood! #ABStrong	Donations and volunteering
Hey guys, emergency Visa prepaid cards available 2 AAMI customers impacted by #bigwet. Contact us @ 13 22 44 if u need assistance #qldfloods	Caution and advice
RT @consumersos: Praying for the people in my hometown #Calgary tonight as waters rise. My high school St.Mary's in flood Zone too....	Sympathy and support
RT @shelleylloydabc: The military convoy has arrived in Bundaberg to help with the massive flood clean-up @abcnews @612brisbane #bigwet	Other Useful Information
Keperra Golf Course, NW Brisbane @abcnews  #bigwet pic by Jay Larkins @Wika1115 URL	Other Useful Information
RT @dailycamera: #Boulder officials reopen trails on Mount Sanitas. #Boulderflood URL via @JoeCarmenRubino	Infrastructure and utilities
RT @QLDOnline: Social media a saviour as Baffle Creek gets cut off URL  #qldfloods #bigwet @justabfab1 #qld	Caution and advice
RT @ABCNews24: #QLDfloods watch: Authorities are preparing for tornadoes in southeast Queensland. We have more from #Brisbane URL ...	Caution and advice
Our thoughts are with the residents of all the affected neighborhoods in the Alberta flooding. #yycflood #abflood	Sympathy and support
RT @boulderoem: If you lost important documents in the flood, we have resources to help replace them: URL #boulderflood	Caution and advice
‚Äú@GlobalEdmonton: Watch: Live stream of the Bow River: URL #abflood‚Äù	Other Useful Information
RT @cnnbrk: Mandatory evacuations in 20 communities in Alberta because of flooding; 100,000 could evacuate in Calgary. URL	Affected individuals
Kerri , much less stressed and happy to be dry @calgaryzoo #yycflood #ableg URL	Affected individuals
RT @CalgaryPolice: Check here to see what areas of Montgomery must be evacuated: URL #yycflood	Caution and advice
Photos: Severe flooding in Australia URL	Infrastructure and utilities
Ipswich could now reach its 15-metre flood peak after midnight (it's 11:05pm up here). Bundaberg still the big danger zone. #BigWet	Caution and advice
RT @YourAnonNews: Video: Flooded #Fracking Sites in Colorado URL #COflood	Other Useful Information
RT @abbassomji: City officials currently speaking to media. #ABflood #YYCflood	Affected individuals
RT @carolynsave Our team made it over weekend 2 #Coloradoflood to help in the @RedCross shelters there to meet needs of #kids Keep the...	Donations and volunteering
RT @windspeakernews: RT @StampedeIP: #morley - looking for trucks/vans to take food and water to Eden Valley. #abflood #yycflood #yychelps	Donations and volunteering
Flood Damage - Who Pays?  #NPR #ColoradoFlood  URL	Other Useful Information
#bigwet RT @Cmdr_Hadfield: Flooding in Maryborough, Australia - visible as we flew over Tuesday morning, 29 Jan. URL	Other Useful Information
RT @smbyyc: PLEASE NOTE - #SMBYYC #41 has been CANCELLED!  Up to 100K ppl affected by #yycflood - we need ppl to stay safe! PLEASE RT	Affected individuals
RT @cnnbrk: More than 500 people are still unaccounted for in Colorado flooding; more heavy rain expected Sunday. URL	Affected individuals
@darrenhayes QLD NSW FLOODS Guy Sebastian is the only celeb to commit ATM. Please say you‚Äôll help. PM me if you can. Thanks (from my heart)	Donations and volunteering
@Fan960Steinberg build the next arena on higher ground? #Flames #yycflood	Caution and advice
Birds, small animals affected by Colorado flooding URL via @examinercom	Other Useful Information
This guy is telling it how it is! Hilarious. Be careful Calgary! Severe Thunderstorm Watch! URL via @youtube #flood #rain	Caution and advice
LOL. RT @Caveman4202003: Wash, rinse, repeat!!!! @KCCOCalgary #yycflood	Not applicable
BBC News - Australian state of Queensland braces for flooding URL	Other Useful Information
#COflood update in @LarimerCounty: We have optimism today... that we'll be able to go at the same rate as yesterday. Incident Command Team	Other Useful Information
Hope once again everyone is safe and well with floods and bushfires across Australia :)	Sympathy and support
01/10:34 EST Flood Warning - Macintyre, Weir &amp; Border Rivers (QLD)  URL	Caution and advice
RT @Greenpeace: Heavy flooding in Canada may force 100,000 people to leave their homes: URL #ClimateChange	Affected individuals
Cc: @jndegz RT @CapitalFM_kenya: Military called in as deadly floods batter Australia URL	Donations and volunteering
#QLD 24/08:19 EST Flood Warning - Macintyre, Weir &amp; Border Rivers (QLD): #QLD 24/08:19 EST Flood Warning - Macin... URL	Caution and advice
Southern Alberta braces for rain amid flood warnings: At least 175,000 people in Alberta have now been ordered... URL	Caution and advice
Let's pull together for our city, #JamaicaYYC!  Check out Volunteer Calgary's 'Flood Donation Drop Off Points and... URL	Donations and volunteering
RT @QPSmedia: What The? Friday - This week, another good reason not to drive through or play in flood waters #wtfriday #bigwet URL ...	Caution and advice
RT @tsvnq: Water across several parts of Hugh Street. Avoid if possible. #townsville #nq #bigwet	Caution and advice
@bendorries the other 2 3rds are probably looking for dry ground #QLDFLOODS # donate #toughtimes	Other Useful Information
RT @QldSES: RT @rrcouncil: If you have your car at the #Rockhampton Airport please move it asap! the car park is likely to flood. #BigWet	Caution and advice
@jordyemmaxx yep, there pretty close.  I need web ones at the moment in qld.  Waits for the floods.	Affected individuals
RT @jasonthistle: Just incredible RT @chmelle: RT @irisheagle High River RT @StephHansenFM: Arial view of High River. Wow. #abflood URL	Other Useful Information
Drones can be cool ‚Äú@ThomasFrey: Drones provide Colorado flooding assistance until FEMA grounded them URL	Other Useful Information
RT @612brisbane: Just over 5,000 homes without power, @Energex crews continue work through the night URL #qldfloods #bigwet	Infrastructure and utilities
RT @wearealberta: A picture from the Stampede Grounds #abflood #yyc URL	Infrastructure and utilities
YIKES!! Tree + Powerlines!! #Toowoomba #bigwet URL	Infrastructure and utilities
It's BS that the government is happy to use drones for military/police work, but not disaster relief. URL #boulderflood	Other Useful Information
RT @happycampergirl: Our mayor is brilliant &amp; hilarious: MT @mehnazt: Stay the $*&amp;!! off the river! #yycflood URL // via‚Ä¶	Caution and advice
Ex-Cyclone Oswald flooding continues. Pic from Ingham, Queensland URL	Other Useful Information
the queensland floods happen every year hope everyone stays safe!	Sympathy and support
RT @TarzanDan: If you are in #Canmore &amp; need help, an emergency line has been set up. Please call 403-678-1551 #abstorm #abflood	Caution and advice
@MargotMicallef OMG, Margot, this looks and sounds terrible. My thoughts are with you and all the people affected by the #ABflood	Sympathy and support
The latest on Colorado‚Äôs devastating flooding: 8 are confirmed dead and 1600 homes have been‚Ä¶ URL	Affected individuals
RT @princessauto: HUGE thanks to our guests who have donated over $11,000  so far to the Red Cross Flood fund!!  #yycflood #ABflood	Donations and volunteering
RT @scottfeeglobal: I think Daisy Duke is the way to go. Just saying... @Calgarystampede  URL #yycflood #hellorhighwater	Not applicable
Help #coloradoflood URL	Donations and volunteering
@Metro_Nolais is that in regards to #transit in #yyc? they are not only ppl affected by this. request your source? #yycflood	Not applicable
Need mechanical help due to #yycflood. Call us. Reduced hourly rates and no overtime for flood victims. We're here to help! Plbg,hvac,gas.	Donations and volunteering
Aftermath of our day. #ColoradoFlood @jujub_14 carrieramz URL	Affected individuals
RT @ajfromhouston: HARRY BLAMES COLORADO FLOODS ON THAT BS WARMING BS!!HIM AND GORE SHOULD BE IN JAIL!!FOR FRUAD!!ENOUGH!!LIES	Other Useful Information
Calgary Flood 2013: Geoengineered Disaster: URL via @youtube	Not applicable
RT @Mookalicious: This pic of an awesome firefighter in Mission needs to go viral.  Please share! #abflood URL	Donations and volunteering
RT @cycloneupdate: Predicted rainfall over the next 48 hours in FNQ. It's gonna get very wet.#bigwet URL	Caution and advice
Thoughts and prayers out to those in Boulder who may not get to Amante for morning coffee. #boulderflood	Sympathy and support
RT @psaulnier: Photos of #yycflood in Sandy Beach Park, Discovery Ridge, Chinatown and Downtown. URL	Other Useful Information
Alberta has pledged $1 billion for the first phase of #abflood recovery. URL	Donations and volunteering
Rescues underway as central Qld floods - Herald Sun URL	Donations and volunteering
just saw the news, queensland is starting to flood, in between bushfires, cyclones, snow storms, and floods are... URL	Infrastructure and utilities
#Abflood #cochrane #hwy22 wow! #yyc #flood #ab URL	Infrastructure and utilities
St Rita's College at Clayfield will operate as usual, with school already scheduled to start on Wednesday. #bigwet	Infrastructure and utilities
Sunday rain leads to multiple water rescues across Colorado Springs: URL #COflood	Affected individuals
Crews having a problem on getting the water out of the way of the electricity #yycflood	Infrastructure and utilities
RT @ChrisScottWx: RT @echo_bryanpass Motorists contend with cascading water over Highway 3 by Crowsnest Lake #abflood URL	Not applicable
RT @AJEnglish: RT @AJEWeather The remains of Tropical Cyclone #Oswald trigger widespread flooding in #Queensland, #Australia: URL ...	Other Useful Information
Though pics have shown the banks have been breached slightly already #bigwet	Other Useful Information
Photo blog post: #yycflood - A peacefully surreal walk around South Glenmore Park. Will share some indivs next. URL #yyc	Other Useful Information
RT @CherylPreheim: Rescues in Broomfield #coflood URL	Donations and volunteering
Internet outage for the past 36 hours.  This is good considering most of QLD is still affected by the #bigwet	Infrastructure and utilities
RT @YourAnonNews: MT @CBS4Mark: Toppled oil tanks spill into Colorado rivers #COflood URL	Infrastructure and utilities
1,750 people evacuated so far by National Guard due to #coflood  URL	Affected individuals
Now observing a moment of silence in memory of the victims of the Colorado floods	Sympathy and support
RT @cnalive: Flood teaches stranded kids lessons in faith URL #COflood #Denver #Catholic #Faith	Affected individuals
Front page of URL lead story. Yikes. #yyc #yycflood	Other Useful Information
Australian state of Queensland hit by deadly flooding - BBC News: BBC NewsAustralian state of Queen... URL #hindusprite	Affected individuals
Another Death Reported in Colorado Floods; 1,200 Still Unaccounted For: Continuing rainfall hampered Colorado ... URL	Affected individuals
RT @CalgaryPolice: Aerial photo of flooding at the Calgary Stampede Grandstand. #yycflood URL	Infrastructure and utilities
RT @cityofcalgary: Prefer to communicate by 'liking'. #yycflood updates on our Facebook page. URL #yyc	Not applicable
Photos I tweeted earlier today were not accessible. Now fixed. #bundaberg #bigwet #qldfloods URL	Other Useful Information
RT @612brisbane: QLD Premier: Flood levels are much lower than 2011. Rain has dropped off and we know what's coming. #bigwet	Other Useful Information
RT @couriermail: #bigwet UPDATE: 250,000 ppl in Brisbane face the threat of no water overnight because of water treatment plant shutdown ...	Other Useful Information
RT @Michelle9647: More spilled oil found in #COflood aftermath, brings total to about 22,000 gallons released: URL	Infrastructure and utilities
RT @dingram: The Australian Govt has an official 'Disaster Watch' app for iOS and Android. Details at URL #bigwet	Caution and advice
South. AB Flood Relief Fund supports LOCAL charities that help those impacted by #abflood Give at URL /cc @DruhFarrell	Donations and volunteering
#flood #Australia Praying for all the People IN Australia Cyclones Are Leaving  But There is minor Flooding everywhere.	Sympathy and support
RT @USArmy: #Soldiers have rescued more than 2,100 people &amp; hundreds of pets displaced by Colorado floods URL @CONG1860	Affected individuals
RT @B105Brisbane: BREAKING NEWS: A tornado has just hit Mooloolaba on the Sunshine Coast. More to come. #BigWet #QldFloods #Newsfeed	Affected individuals
RT @paulbrandt: Get the Alberta Strong (Flood Montage) as heard on @Country105_FM &amp; @CISNCountry supporting Alberta Flood Relief! URL	Not applicable
RT @9NEWS: Colorado flooding: 3 killed; flood waters force evacuations, destroy roads URL #COFlood	Affected individuals
@Kenny_Wallace HI Kenny!  Do u know if Furniture Row shop affected by Colorado flooding?	Infrastructure and utilities
RT @cnnbrk: More than 500 people are still unaccounted for in Colorado flooding; more heavy rain expected Sunday. URL	Affected individuals
Special Report: Disaster Response - Colorado Floods URL	Other Useful Information
@ValentineEliza you have no idea how much I wish I was there helping you outüòûüíó #sosorry #loveyou #yycflood	Sympathy and support
Sqwerl ResQte In Colorado: We‚Äôve all read about the bad flooding in Colorado. It‚Äôs taken a terrible toll on ho... URL	Not applicable
‚Äú@SylviaJeffreys: ‚Äú@couttskid: Yamba Road is now closed due to flooding.‚Äù #bigwet‚Äù @JohnMcReynolds1 just made it mate	Infrastructure and utilities
RT @WorkSafeQLD: Make sure your workers have the correct PPE for cleaning up after flooding. #bigwet URL	Caution and advice
Who's tryin to tube on boulder creek right now? #boulderflood	Other Useful Information
I got a @nenshi shirt, will you? URL #yycflood #redcross	Donations and volunteering
Flooding shuts down popular Colorado tourist destinations URL	Infrastructure and utilities
RT @DenverChannel: 1,253 people remain 'unaccounted for' in the #COflood. Details on @7NewsNOW 5-7a: URL #UpWith7News	Affected individuals
PHOTOS: tour shows u.s. hwy. 36 damage from colorado floods near lyons. #coflood #cowx URL	Infrastructure and utilities
