Colorado fire news: URL via @msnbc	Other Useful Information
Colorado wildfire of 'epic proportions' displaces 32,000: Firefighters again will battle inferno-like conditions... URL	Affected individuals
Social Media and Village Crisis Comms ‚Äì Local Gov Councils and Emergency Services #NSWFires URL	Other Useful Information
My poor baby Colorado Springs. My hearts out to my hometown. &lt;3 The United States is so dry that fires ar        (cont) URL	Sympathy and support
@BBAU9 #BBAU - nsw fires wasn't Tim from Katoomba - plz google it	Other Useful Information
#newbedon 6/25/2012 9:18:21 PM Colorado fire near Pikes Peak forces 11,000 from homes URL	Affected individuals
RT @NSWRFS: Fire near Bells Line Rd has burnt approx 24,000 hectares. 140km of fire edge. #NSWRFS #nswfires URL	Infrastructure and utilities
#RedSun #SmokedClouds #SydneyFires #SummerGonBurnErrthang! URL	Not applicable
RT @Mo_Taha1: A Winmalee house thermometer melted due to the intensity of the flames. @abcnews @702sydney #nswfires URL	Infrastructure and utilities
Starting to get the smoke from the fires from Sydney hear in Albury @NSWRFS @7NewsSydney #7NewsAt7 #nswfires #7NewsSyd	Other Useful Information
RT @Colorado: Custom tees - 100% of proceeds benefit Colorado wildfire victims: URL #COFires	Donations and volunteering
RT @sfarnsworthmelb: Above Mount Irvine #nswfires meet the clouds @abcnews URL	Other Useful Information
Colorado Wildfire Now 50 Percent Contained - LEX18 Lexington KY News URL	Other Useful Information
Has the smoke from the #HighParkFire altered your #bicycle riding this summer? If so contact me at davidyoung@coloradoan.com	Other Useful Information
@billmaher please RT - help Colorado Springs with the #WaldoCanyonFire URL we need all the help we can get right now!	Donations and volunteering
RT @Nyx2701: ‚Äú@9NewsSyd: #Springwood fire now threatening St Columba‚Äôs School. #nswfires URL #BlueMountains #BushFires	Caution and advice
RT @workmanalice: Amazing photo from a friend in Katoomba on the road to Blackheath. #nswfires URL	Other Useful Information
RT @BabyBash: Yeah I have lots of friends and fam in Colorado,, keep a blessing for them! Battling them big wild fires!! Many lost house ...	Affected individuals
RT @katelynburkhart: praying for the people, animals and entire communities affected by this #highparkfire. truly unreal.	Sympathy and support
RT @BreakingNews: Destructive fire near Colorado Springs, Colorado, doubled size overnight to over 24 square miles - @AP	Other Useful Information
Australia broke over 120 extreme weather related records in 2012/13 summer, Now record temps &amp; bush fires in OCT already #auspol #cliamte	Other Useful Information
Colorado wildfires their worst in a decade URL	Other Useful Information
RT @MmaGeneration: UFC Heavyweight Shane Carwin on the Colorado Fires + Getting Back to the Octagon URL @ShaneCarwin	Sympathy and support
Australia wild fires: Thousands flee homes as bushfires ravage New South Wales, Australia URL	Other Useful Information
RT @DamonAM: My opinion of the @NSWRFS neatly summarised into a comic. #nswfires URL	Other Useful Information
RT @nytimes: Furious Wildfire in Colorado Leaves Destruction in Its Wake URL	Infrastructure and utilities
@csgazette reporting that Colorado Springs is under another red flag warning today. #WaldoCanyonFire	Caution and advice
Forest / Wild Fire - Australia - Australia: EDIS Number: WF-20131013-41255-AUSDate / time:... URL #anonymous #anonops	Caution and advice
Scenes from bush fires near Sydney  URL	Other Useful Information
Oh Wow! Remembering when I use to live in Colorado Springs, glad I didn't experience anything like these fires!	Other Useful Information
RT @ahleach: ‚Äú@PMOnAir: Adam Bandt is a disgrace. I can't think for a more inappropriate tweet. #nswfires #sydfires #pmlive  URL	Other Useful Information
RT @USFWSHQ: We're reading @latimes: Colorado wildfire could burn all summer, officials fear URL	Other Useful Information
RT @TheDingoTracker: Thoughts are with all the people and animals fighting and fleeing fires in NSW @NSWRFS @OEHmedia @NPWSnorthern @BMWHI	Sympathy and support
RT @BlueDuPage: Romney plan for #Colorado wildfires :  Fire  firefighters. Ignore climate change.  Take $$$ from Koch Brothers.  #Mitt20 ...	Other Useful Information
#Sydney #fire please be over right now!! URL	Other Useful Information
RT @derindevine: There are a total of 95 fires burning across New South Wales, I can't even fathom that #nswfires	Other Useful Information
@Sandra_Sully: .@_AdamTodd: Bushfires at Springwood as the sun sets #nswfires #eyewitnessnews URL	Other Useful Information
RT @NSWRFS: Maybe we will use our Fires Near Me phone app, not American TV networks for fire information. #nswrfs #nswfires URL	Other Useful Information
New #HighParkFire Evacs: 474 evac notices S &amp; W of Bellvue includes Lory State Park, Redstone Canyon &amp; Buckhorn Rd to Stove Prairie School	Affected individuals
RT @grist: This image from NASA shows the scar from the Waldo Canyon fire in Colorado: URL Pretty sure it'll blow your  ...	Other Useful Information
Photo of the Colorado wildfire from space (via @NASA) URL #HighParkFire #FortCollins #Highpark #Lemay via @michaelhayes	Other Useful Information
@9NewsAdel feeling for the people of NSW. I have friends who have lost their home in this bush fires.	Sympathy and support
Ack! A fire now in Boulder!	Other Useful Information
RT @CraigHavenr: Man that lost his house in NSW FIRE  We knew it was coming 7 years of fuel built up because green councils wouldn't burn ‚Ä¶	Infrastructure and utilities
RT @cnni: 32,000 evaculated from Colorado wildfires URL	Affected individuals
RT @BBC_WHYS: Live talking to #firefighters and residents around #NSWfires Listen  URL   everyone indebted to the fire ‚Ä¶	Sympathy and support
In Vail Colorado having a blast!!! Hope the wildfires don't spread to where I'm staying!!!:/	Not applicable
@alan_arnette Moore Animal Hosptal in FC offering free small animal boarding and pick up for #highparkfire evacuees. 970-560-0452 for info.	Donations and volunteering
RT @HuffingtonPost: LOOK: Colorado's multiple wildfires as seen from space URL	Other Useful Information
#highparkfire It's a slow progress, but we need to have favorable weather and we've had that the last couple of days.	Other Useful Information
@Leonuhhh @cupsaucerblog @VickiHigham sounds like Australia! But with simultaneous bush fires and floods.	Other Useful Information
Mashable: 9 shocking Twitter pictures of Colorado Springs wildfires. Hoping our relatives there are safe. #in URL	Affected individuals
RT @nickgroke: Totally amazing and completely horrible photo from the Colorado Springs fire: URL #waldocanyonfire #cofire	Other Useful Information
[LIVESTREAM] Waldo Caynon Fire Colorado USA URL URL	Other Useful Information
RT @Colorado: Please RT: Text the word FIRE to 80000 to donate $10 to the Colorado Fire Relief Fund 2012 @mgive	Donations and volunteering
RT+@KCCINews:   #Australia bush #fires blaze in New South Wales URL	Other Useful Information
4 Northern Rockies T2IA Crews are mobilizing to Colorado and New Mexico to assist with wildland fire suppression efforts.	Other Useful Information
RT @climatecouncil: David Jones, Bureau of Meteorology, said climate change will see fire conditions worsen for much of Australia URL	Other Useful Information
Conservatives Blame Obama For Colorado Wildfires | TPMMuckraker URL	Other Useful Information
Sending love and support to all those who have tragically lost their homes and  lives in the fires in NSW. Sending love your way! #nswfires	Sympathy and support
New game... Drink everytime you see a Sydney Bushfire photo on your Instagram feed... GO!.. OK I'll call you and ambulance now :-( #nswfires	Other Useful Information
At least 57 bush fires are raging in eastern Australia, including 14 that aren't contained, officials said. URL	Other Useful Information
RT @NationalPrayer: Heavenly Father, please be with the men and women fighting the #WaldoCanyonFire in the Colorado Springs area. Please ...	Sympathy and support
Met a woman today who escaped her town in Boulder because of the fires...her house is completely destroyed. #humbled #prayingtime	Infrastructure and utilities
Homeowners from the Stratton Park, Pine Acres/ parts of Poudre Canyon have been notified that their homes have been destroyed. #HighParkFire	Infrastructure and utilities
Pic: #CoFire: Helicopter drops water on #WaldoCanyonFire #Wildfire USAF Academy Colorado Springs, Colo. URL	Other Useful Information
RT @HumaneSociety: .@winecountrydog it is still open to large animals just not people #highparkfire	Donations and volunteering
Australia weather increases threat of fires: Fifteen fires continue to burn out of control in  New South Wales... URL	Infrastructure and utilities
RT @tri1025: RT @LarimerSheriff: #HighParkFire Residents of Red Feather Lakes and Crystal Lakes need to use Cherokee Park Road (CR 80C)...	Caution and advice
RT @702sydney: Another shot of the cricket at #Faulconbridge A full pitch view  Photographer- @John__Donegan #nswfires @NSWRFS URL	Affected individuals
RT @muzdog10: Water bombing at Hartley Vale this afternoon. #nswfires #Lithgow URL	Not applicable
Unbelievable community support in Colorado Springs! URL	Sympathy and support
#AusPol @TonyAbbottMHR quotes Dorothea Mackellar to explain Australia's ability to cope with fire: URL	Other Useful Information
Colorado Springs on fire. URL	Other Useful Information
Australia fires: Firefighters fought scores of bush fires blazing in Australia's New South Wales early Friday. URL	Other Useful Information
Is support of those fighting the fire in northern Colorado, we say THREE CHEERS FOR FIRE FIGHTERS! Here's a view... URL	Sympathy and support
RT @NSWRFS: 4:05pm Media briefing with Commissioner Shane Fitzsimmons being live streamed now - URL #nswfires #NSWRFS	Other Useful Information
RT @_PDT: .@1233newcastle just drove back from Sydney and passed a few Rural Fire trucks heading north ....	Affected individuals
No wonder my allergies are crazy. Please pray for the fire in Colorado to be gotten under control, so scary and so sad URL	Sympathy and support
Colorado wildfire worsens, forcing 7,000 more from homes: COLORADO SPRINGS (Reuters) - A monster Colorado wildfire raging near some o...	Affected individuals
RFS Commissioner says he still has concerns for #Springwood blaze  #nswfires	Caution and advice
RT @BBCWorld: One bushfire 300km (186 miles) wide, Victoria's fire chief tells BBC World News, as he sends 100 firefighters to NSW URL	Caution and advice
@NoradNorthcom &amp; @PeteAFB report that a C-130 helping with the Colorado wildfire effort crashed in South Dakota at about 6 pm MDT	Other Useful Information
RT @702sydney: Incredible photo of @NSWRFS firefighter engulfed in flame and crawling out of the fire.He is OK #nswfires URL	Affected individuals
RT @newscomauHQ: FIRE UPDATE: Families told to be ready to run as a massive 300km wall of fire sweeps through Blue Mtns. #nswfires | URL	Caution and advice
RT @instagram: Frightening photo of the Colorado #wildfire by @dredayy66: URL Please stay safe!	Other Useful Information
RT @KLOVERadio: Please RT if you will join us in praying for those impacted by the fires in Colorado &amp; those fighting the fires. htt ...	Sympathy and support
Watch 11.05 22/10 RFS media briefing by NSW Rural Fire Service on URL URL	Caution and advice
RT @SarahBisbing: #HighParkFire #ecosystems Densely stocked forest, extremely dry fuels, lack of precip, and high winds = fire likely to ...	Other Useful Information
RT @u2videoqueen: Smoke plume from #HighParkFire.  Viewed from Northern #Boulder county. URL	Other Useful Information
Huffingtonpost news Colorado Wildfires 2012 Photos: Pictures Of Colorado's Worst Fire Season In A Decade (PHOTOS...  URL	Other Useful Information
CNN: Colorado wildfire hops road URL	Other Useful Information
Nothing lower than fire looters: NSW cops URL	Other Useful Information
RT @abcnews: NSW RFS Deputy Commissioner Rob Rogers describes Lithgow blaze as a monster fire. More: URL #NSWfires	Caution and advice
RT @Vic_Rollison: @AdamBandt here is my response to the abuse you received about linking climate change to NSW fires. URL	Other Useful Information
The fire in Colorado might burn down the hospital I was born at )':	Infrastructure and utilities
RT @truuebluu: Don't forget our mates in the bushfires. #NSWfires URL	Sympathy and support
RT @BreakingNews: Colorado wildfire now over 50,000 acres, officials say; more than 1,300 personnel battling the blaze - @denverpost  ht ...	Other Useful Information
15:58 Oct 21 NSW #Bushfire Emergency Warning: Springwood (Blue Mountains).  Details: URL	Caution and advice
RT @smh: The entire Blue Mountains area as well as Penrith and Richmond are in danger of burning over the next few days. #nswfires	Caution and advice
Unrelenting fires burn Australia: At least 57 bush fires are raging in eastern Australia, including 14 that ar... URL	Other Useful Information
@Louis_Tomlinson please help support the RFS and Blue Mountain Appeal and help those suffering from the NSW fires x	Donations and volunteering
Unprecedented Colorado Wildfires Continue, As Strong Winds and Looting Add to the Problem: (The Blaze/AP) -- Cre... URL	Other Useful Information
RT @ColoradoJohnQ: RT@balls_deepinpow: Colorado Springs fire URL #waldocanyonfire‚Äù	Other Useful Information
RT @illwah: Love your prayers in Aust for the NSW fires. Over 200 homes lost now &amp; 80 different fires burning. Pls pray for our fire fighte‚Ä¶	Sympathy and support
RT @ksbw: Hundreds of homes destroyed in raging Colorado fire: Colorado Springs officials said Thursday that hundreds of homes... URL ...	Infrastructure and utilities
‚Äú@news_com_au: THE wildfire burning just west of Fort Collins, Colorado, has destroyed 181 homes, ... URL	Infrastructure and utilities
Furious Wildfire in Colorado Leaves Destruction in Its Wake: Thousands have been forced to flee the flames, whic... URL	Affected individuals
RT @JamelleWellsABC: RFS Comish says his focus during tomorrow's tough weather conditions will be to save lives.#nswfires @abcnewsNSW @ABCN‚Ä¶	Other Useful Information
@nswrfs thanks @QantasAirways . Their staff in groups helping to take our interstate colleagues home today and tomorrow #nswfires	Donations and volunteering
RT @BSidesNarrative: I just heard on @DenverChannel that some  hotels in Colorado Springs are price gauging evacuees. If you hear of one ...	Other Useful Information
RT @KevinMinott: How Social Media Is Helping Colorado Wildfire Relief: More About: disaster relief, red cross, Social Media URL ...	Other Useful Information
9 Shocking Twitter Pictures From the Colorado Springs Wildfire URL	Other Useful Information
RT @Jon_G3: Seeing 1/3 of Colorado on fire makes me wonder how certain political figures can argue cutting fire fighter numbers #COFire	Sympathy and support
RT @dailytelegraph: Follow @NSWRFS - they are live tweeting all information they have immediately. @nswfires #bushfires #sydneyfires Blue M‚Ä¶	Caution and advice
Colorado #wildfires: 32,000 evacuated as blaze jumps perimeter near Colorado Springs | URL	Affected individuals
RT @CarolHink: As we are thinking about fireworks today in #CA...I can't help but think about all the peeps dealing w/ the #COFire &gt;& ...	Sympathy and support
For the latest on the massive #HighParkFire, follow @CBSDenver and get the details here: URL	Other Useful Information
All of  #CT haze today  is from the colorado wildfires	Other Useful Information
RT @amworldtodaypm: Coming up on TWT: One dead &amp; more than 100 homes lost in what has been called the worst #bushfire day in #NSW in more t‚Ä¶	Affected individuals
RT @NASA: A bad fire day in New South Wales, Australia, yesterday. Look at this image from our Aqua satellite: URL @NASA‚Ä¶	Other Useful Information
RT @BreakingNews: Evacuation order issued in Colorado's High Park Fire - @LarimerSheriff URL	Affected individuals
RT @rglover702: There are handwritten signs like this all over the Blue Mts. #nswfires @702sydney URL	Other Useful Information
RT @LogansLaundry: At a shoot right near Sydney fires!! There is ash embers flying into my eyes!!	Other Useful Information
#nswfires #backburning operations  If you see an unattended #nswfire call Triple Zero, (000) immediately.  Do not call 000 to report smoke	Caution and advice
Beautiful morning in Sydney, sunshine and clear sky's - I hope this weather eases conditions for the fires across NSW.	Sympathy and support
RT @NSWRFS: If you find an injured native animal, call WIRES 13000WIRES or DPI for livestock.  URL @WIRES_NSW #nswfires	Caution and advice
RT @bromleyfalco: @KRQEMark Good work on the  #cofire updates Mark. I'm from Denver, been in NM about 9 months now...thx sadly we know fire	Affected individuals
RT @EmMastronardi: If you want to put the Lithgow fire in perspective, here is the size outlaid on a map of Sydney. #nswfires URL	Other Useful Information
RT @NSWRFS: #NSWRFS Commissioner Shane Fitzsimmons: If we get through with less than 100 homes destroyed today, we have been lucky. #nswf‚Ä¶	Infrastructure and utilities
Our hearts go out to all those affected by the terrible fires. Stay safe. NSW Rural Fire Service - Bush Fire... URL	Sympathy and support
#waldocanyonfire #waldofire sending as much positive thoughts as I can to C Springs. Love that land!	Sympathy and support
RT @Optus: With Optus? Text DONATE to 19 Relief (19 735433) to donate $5. All funds will go to @RedCrossAU work with #NSWbushfires &amp; other ‚Ä¶	Donations and volunteering
RT @NSWRFS: Ash and smoke from Hall Rd #Balmoral fire visible in the Illawarra. #NSWRFS. #nswfires	Other Useful Information
Cocktails and apps to benefit colorado wildfire relief at the laundry. @dawnhancock would be very proud!	Donations and volunteering
Colorado wildfire hops road: Firefighters Thursday made progress against a massive wildfire 15 miles west of For... URL	Affected individuals
Be praying, this is very close to where my parents and sister live...WALDO CANYON FIRE - Colorado Springs Gazette, CO URL	Sympathy and support
Dear NSW, if we could give you some if our weather, we would. From VIC #nswfires	Sympathy and support
Mayor: Colorado Springs Fire Destroys 346 Homes: Mayor: Colorado Springs fire destroys 346 homes	Infrastructure and utilities
Fears Australia blazes could merge: Wildfires in New South Wales could merge to form a massive blaze, the fire... URL	Other Useful Information
Sydney real estate Strong winds fuel Dudley, Redhead fires prompting return to 'watch and act .... URL house for sale	Infrastructure and utilities
Prayers for the firefighters &amp; anyone affected by the wildfires in Colorado. ‚ù§	Sympathy and support
Australia declares fire emergency: A state of emergency is declared in New South Wales as Australian firefight... URL	Caution and advice
RT @samanthabarry: Striking image from my sister in Sydney #nswfires Seven major bushfires are burning across New South Wales. URL	Other Useful Information
RT @9NEWS: #HIGHPARKFIRE now 45% containment, has burned 55,050 acres.  #9NEWS	Infrastructure and utilities
RT @nswfire: URGENT MESSAGE RESIDENTS NORTH OF #SWANSEA #NSW YOU ARE IMMINENT DANGER #EVACATE NOW GO TO #SWANSEA NORTH ONLY #FIRE UNDERGROU‚Ä¶	Caution and advice
RT @YourAnonNews: Colorado Springs, CO is on fire. 65mph winds blew it into the city today. Looked like Armageddon. #WaldoCanyonFire | h ...	Other Useful Information
RT @KyleLSaunders: Whoops, wrong link: #HighParkFire threatens largest Buddhist temple in North America URL	Infrastructure and utilities
@Harry_Styles can you just do a quick shout out to all of the fire victims in Colorado? over 32,000 are evacuated...it would mean a lot!(:	Sympathy and support
About 80 bush fires all around NSW today.. This sky is starting to look a little creepy. URL	Affected individuals
#bushfires #nswfires #sydney URL	Not applicable
1994 South Canyon Fire Fatalities Lessons Learned: URL #AlwaysRemember URL #COFire	Caution and advice
Colorado fire claims first victim, ranks as state's most destructive: COLORADO SPRINGS, Colo. (Reuters) - A fier... URL	Affected individuals
RT @NSWRFS: Infrared image from #Lithgow fire - fire is spotting ahead, very intense activity. #NSWRFS #nswfires URL	Other Useful Information
NSW Premier Barry O'Farrell says Defence stopped aircraft flying over area because of those exploding ordinances. #nswfires @abcnews	Infrastructure and utilities
Let's hope &amp; pray that today won't be as disastrous as predicted #nswfires Stay safe.	Sympathy and support
RT @cmyers75: ‚Äú@cmyers75 ‚Äú@Engadine_RFB ‚Äú@BrentSGibson: Smoke seen  Williamtown Airport  #nswfires #Newcastle URL @ten‚Ä¶	Other Useful Information
#Media Large wildfire in N. Colorado prompts evacuations: Crews are battling a fast-moving wildf... URL #Politics #News	Affected individuals
Here's a pic of Colorado and the fires from space. URL	Other Useful Information
Good thing there's a bunch of fires in Colorado.....and I'm going there in two days.... #PrayForColorado	Other Useful Information
RT @SebHenbest: To not talk about #climate when fires a raging through NSW in Oct! is like not talking about guns after a US massacre URL	Other Useful Information
We're thinking of those fighting the fires in NSW and those whose homes and businesses are under threat. Stay... URL	Sympathy and support
RT @RedCrossAU: It's another high risk day for #NSWfires. Donate to help affected #communities respond &amp; recover: URL	Donations and volunteering
The High Park fire west of Fort Collins, #CO has consumed 36,930 acres so far, is 0% contained and continues to grow. #NWS #cowx #cofire	Infrastructure and utilities
Great info on how to help #people and #pets URL via @ColoradoStateU #HighParkFire #cofire	Other Useful Information
So thankful to be back in Adelaide, the fires in Sydney are horrific and seeing them as we flew out showed the devastation first hand #sad	Sympathy and support
RT @NASA: A bad fire day in New South Wales, Australia, yesterday. Look at this image from our Aqua satellite: URL @NASA‚Ä¶	Other Useful Information
RT @robrfs: People need to understand that the danger is not over for people on any of the active firegrounds. Many hours to go. #nswfires	Other Useful Information
RT @DanniiMinogue: NSW Australia: 59 bush fires. Hoping today luck is on our side for residents and fire fighters.üçÄüê®	Sympathy and support
We're hearing a few smoke reports on the #Boulder scanner this afternoon, so far no confirmed lightning-strike fires	Affected individuals
RT @jerradtyson: My thoughts are w evry1 affected by the current bush fires. Stay safe &amp; be smart! Pic: smoke blanketing West Sydney URL	Sympathy and support
RFS Comish says leaving early is safest option in fire danger areas tomorrow,. Says Minutes will matter. #nswfires @abcnews24 @702sydney	Caution and advice
Huge forest fire here in Colorado up in the mountains	Other Useful Information
my state has 8 fires. woooo colorado	Other Useful Information
RT @Colvinius: Fewer people can now claim disaster payments under Federal Govt changes made yesterday. URL #NSWFIRES via‚Ä¶	Other Useful Information
RT @CitizenRadio: THE BIG ANNOUNCEMENT, #Colorado is on fire, Louis C.K. scares the crap out of suits everywhere URL #C ...	Not applicable
RT @zanrowe: Heartfelt thanks, as always, to the incredibly brave firefighters battling these sudden shocking bush fires in NSW. Stay safe.‚Ä¶	Sympathy and support
Springwood fires earlier today  #nswfires #bushfires  URL and URL it was scary stuff!	Caution and advice
Colorado wildfire: Last Chance, residents stand tall after huge wildfire URL	Affected individuals
RT @JohnJohnsonson: EXLCUSIVE: FIRST PICS OF LUTING IN #NSWFIRES URL	Affected individuals
RT @rickhowerton: Please pray for my @NavPress friends homes and for Glen Eyrie to be spared. Wildfires sweeping through Colorado Springs.	Sympathy and support
Follow @TaliahBeatz RT @ressiVdanor RT @HADIARE: #OPENFOLLOW Fort Collins, Colorado Wildfire Spreads As New Mexico ...  Follow @JiNxBeatz	Other Useful Information
RT @denvernews: Denver News: Colorado to sizzle with record heat Monday, fire danger is high URL	Other Useful Information
üôèpray for the victims of the Colorado firesüî• It's getting bad out there üòî	Sympathy and support
RT @3AW693: Is there a link between climate change and #NSWfires, as a UN expert has said? I think she's talking through her hat, says Mr‚Ä¶	Other Useful Information
RT @HomefrontHugs: We have hundreds of military families &amp; veterans evacuating from the fires now in Colorado -We needed a wake up c ...	Affected individuals
Fitz 7:05AM presser: 70-80km/h SW winds expected again today for #BlueMountains. #nswfires	Caution and advice
This map gives you a sense of how big the fires are in the Blue Mountains region. #nswfires URL	Other Useful Information
RT @9NEWS: Evacuations lifted in Flagstaff Fire near Boulder  #9NEWSHeadlines	Caution and advice
RT @BrianCHouston: Could you please pray for our home state in Australia, where the bush fire situation continues to worsen in treacherous ‚Ä¶	Sympathy and support
RT @smh: A blood red sky over Tom Uglys Bridge in south Sydney. Photo: Chris Lane. #nswfires URL	Affected individuals
RT @AlBoeNEWS: BREAKING -- Firefighter tells local media that 200-300 homes have been lost in Waldo Canyon fire burning in Colorado	Infrastructure and utilities
RT @KUNC: #HighParkFire: New Evacuations Ordered URL	Caution and advice
RT @ABCNews24: Fitzsimmons: I sincerely plead with people don't become complacent #nswfires URL #NSWRFS	Other Useful Information
#photo mt @SallieLodewyck View of #FlagstaffFire from jay rd and spine URL #loc 40.051057,-105.216107	Other Useful Information
Lithgow bushfires #nswfires URL	Other Useful Information
RT @workmanalice: Amazing photo from a friend in Katoomba on the road to Blackheath. #nswfires URL	Other Useful Information
RT @FireRescueNSW: #FRNSW &amp; #NSWRFS f/fighters have been busy across the Blue Mtns. One #FRNSW f/fighter rescued this guy. URL	Affected individuals
RT @NSWRFS: Important information about donations URL #nswfires	Donations and volunteering
RT @nswfire: #nswfires Pics URL Oct18 @davidreid1 URL Oct13 @FireRescueNSW URL @An‚Ä¶	Not applicable
RT @gannett: Terrific panorama shot of the #HighParkFire from @MattStephens with the @coloradoan.  URL	Other Useful Information
Colorado wildfire destroys 8 more homes; structure toll at 189 URL	Infrastructure and utilities
Colorado fires sweep social media sites as readers look for info - Denver Post URL	Other Useful Information
Colorado wildfire now 50 percent contained URL	Other Useful Information
The pilot of the fire-fighting plane tha crashed W of Ulladulla, NSW has died :-( @QldFire #nsw	Affected individuals
RT @Magdalena_Roze: This ISN'T rain on SYDNEY RADAR! Its a massive smoke plume from LITHGO FIRES travelling to coast by NW winds! #fires ht‚Ä¶	Other Useful Information
Watch live:  Colorado Wildfire Aerials URL	Other Useful Information
RT @cnnbrk: Officials: At least 57 bush fires rage in Australia; state of emergency declared URL	Caution and advice
RT @nzherald: The front page of today‚Äôs New Zealand Herald: ‚ÄúInferno: The Great Escape‚Äù URL #nswfires URL	Other Useful Information
@beyondzeronews:  @AdamBandt s--go away worst fires were 1823 cop that for a change hotest day was 1908 george st sydney 48d killd all oxen	Other Useful Information
#Davis Colorado Springs Waldo Canyon wildfire forces thousands to flee flames URL	Affected individuals
Stay safe NSW. Such a country of contrasts. Freezing here in Vic, bushfires in NSW. CC deniers will say it's normal I bet. #nswfires	Other Useful Information
RT @GOPrincess: You know... These Colorado wildfires are on their way to becoming Obama's FEMA disaster, ala Katrina. Slow-moving silenc ...	Other Useful Information
On going great work from the fireries. Thanks so much. #NSWRFS #nswfires URL	Sympathy and support
@electravision I am waiting for the carbon tax bill for the bush fires in nsw. Who will they send it to?	Other Useful Information
RT @ANACoins: Here's our full statement on how the #waldofire is impacting the #ANASummerSeminar: URL	Caution and advice
RT @AFSpace: AFSPC Vandenberg Hot Shots are on the ground in Colorado Springs helping fight the #WaldoCanyonFire as we speak: URL ...	Infrastructure and utilities
RT @AmandaGearing: Oakdale Road resident  Choppers flying over. Police doorknocking asking residents to prepare to evacuate. #nswfires #NSW‚Ä¶	Donations and volunteering
Colorado wildfire 'moving fast' URL	Other Useful Information
RT @climatecouncil: David Jones, Bureau of Meteorology, said climate change will see fire conditions worsen for much of Australia URL	Other Useful Information
New forest fire just broke out in Boulder! 14 forest fires in CO right now! Praying my heart out!	Sympathy and support
#OPENFOLLOW Weather fear as Australia fires burn: More than 3,000 firefighters in Australia ba... URL #TEAMFOLLOWBACK	Other Useful Information
RT @TimesCall: Colorado's High Park fire has burned nearly 58 square miles. URL	Other Useful Information
Winmalee North fire taking off. #nswfires SkyCrane water-bombing.	Other Useful Information
RT @Swills33: To say Colorado needs rain would be a massive understatement. Heartbroken to see the destruction these fires are causing.  ...	Sympathy and support
RT @thetodayshow: 34 fires still uncontained across NSW. Please contact Public Info &amp; Inquiry line if you are concerned: 1800 227 228. #nsw‚Ä¶	Caution and advice
@twitterau during the #nswfires	Other Useful Information
#50radio #NowPlaying 5-0 Radio app (Larimer County Fire and EMS) rr://7897 #highparkfire	Other Useful Information
RT @stellar_zee: @andersoncooper are you seeing what is happening in colorado springs? major wildfire, 32,000 evacuated. major news nets ...	Affected individuals
RT @Denver_Broncos: Broncos pledge $50,000 to Colorado wildfire relief efforts URL	Donations and volunteering
If you missed it last night here is an article on what to do when there is fire danger. #nswfires #bushfire URL	Caution and advice
RT @stevebruskCNN: President Obama has landed back in Washington after the trip to the Colorado fires. The first family goes to Camp Dav ...	Other Useful Information
RT @Meagan9News: Concern today for #highparkfire: Explosive weather conditions because of heat, high winds and low humidity.	Other Useful Information
RT @LarimerSheriff: #HighParkFire Another evacuation area notice has been lifted. Please check out link URL	Caution and advice
The firies seem to be doing an amazing job. Keep it up. #auspol #nswrfs	Sympathy and support
@rqskye I'm in Boulder so about 50 miles southwest of the fire.  I have seen numerous reports of wind.  Not good.	Other Useful Information
RT @reesaface: Praying for safety for everyone who lives in the springs near the fire and all the other fires going on in Colorado right ...	Sympathy and support
It is doingsome raining #onthefarm!!!   LORD send of this to put out the fires in Colorado.  #Thrutheflames safety!!!   #BelovedofGOD	Sympathy and support
i cant believe this is happening... the NW side of Colorado Springs is on fire right now... this is the most devastating thing ive ever seen	Other Useful Information
Top Story: Fears of 'mega-fire' forming: Australia firefighters are worried that two separate f... URL #ERMmedia @CNN	Other Useful Information
Colorado fire 'smacks you in the face' - Neighborhoods in Colorado Springs, Colorado, are evacuated as the Waldo Can... URL	Affected individuals
BBC News - Home: Colorado fire efforts gain ground:                     BBC News - Home                        T... URL	Other Useful Information
RT @7NewsSydney: GALLERY: #NSW bushfire devastation in pictures: URL #nswfires	Other Useful Information
Bush fires menace Australia homes URL	Infrastructure and utilities
Shane Fitzsimmons to #BlueMountains residents I would suggest that you need to leave tomorrow.. before lunchtime @NSWRFS #nswfires	Caution and advice
Colorado wildfire smoke chokes Cheyenne, Wyo. ‚Äì URL URL	Other Useful Information
RT @ProFootballTalk: Broncos DE touched by Colorado wildfire tragedy URL	Sympathy and support
Police chief: One dead, one missing in Colorado fire - Washington Post URL #PoliceNews	Affected individuals
Australia scorched as 56 fires rage URL	Other Useful Information
Local RFS team advise a meeting will be held tonight at the #Blackheath Community Centre at 7:30pm #nswfires	Caution and advice
RT @NSWRFS: Linksview Rd (Springwood): An Air crane has been deployed to assist crews. #nswfires #NSWRFS	Other Useful Information
Rain on the windscreen looking out at firetrucks at #Faulconbridge URL	Affected individuals
@PortDouglasSK yes some good rain would be very beneficial #nswfires	Other Useful Information
#newbedon 6/28/2012 10:00:53 AM Colorado fire near Pikes Peak forces 11,000 from homes URL	Affected individuals
RT @TallaraSkyee: Went back home today. Still can't believe it's gone #nswfires #Winmalee #fires URL	Affected individuals
Great, Boulder on fire too	Other Useful Information
Colorado fire displaces hundreds; 1 person missing: Firefighters in Colorado and New Mexico are battling wind-fu... URL	Affected individuals
Crews go on offensive against growing Colorado wildfire URL #KRDO	Other Useful Information
RT @ch150ch: Abbott (who claims exps for runs, swims &amp; bike rides) changes rules so less people to get #nswfires disaster payment URL	Other Useful Information
RT @Channel9: #NSWFires UPDATE: A big concern for the area of Wilton. An Emergency warning has been issued residents should seek shelter. @‚Ä¶	Caution and advice
Fears Increase That Aussie Super-Fires May Merge Outside Sydney URL	Other Useful Information
#HighParkFire from I-25. URL	Other Useful Information
The bush fire threat to the Blue Mountains west of Sydney has been averted for the rest of today according to officials. #CroozeFmNews	Infrastructure and utilities
Visits home allowed in areas burned by Colorado fires: People who fled the most destructive fire in Colorado's h... URL	Other Useful Information
RT @barryofarrell: great to know there are more than 650 personnel from other States &amp; Territories currently helping in NSW with #nswfires ‚Ä¶	Affected individuals
Colorado Wildfires: Online Community Steps Up URL	Donations and volunteering
RT @Lisa_Wilkinson: To all the men &amp; women out there today fighting the good fight in the worsening #nswbushfires thank you. Your bravery &amp;‚Ä¶	Sympathy and support
Colorado wildfire: dramatic photographs of #highparkfire. URL	Other Useful Information
Raging US wildfire continues to ravage Colorado | List Submission: URL	Other Useful Information
Good morning - 6pm producer Duncan Shaw here with the morning news meeting.  We'll be covering the #cofire all day long.	Other Useful Information
Photo: Colorado wildfire near Air Force‚Äôs Falcon Stadium URL	Other Useful Information
Explosives sparking blazes &amp; arsons sure doesn't sound like climate change to me. #nswfires #auspol	Other Useful Information
I've got family in Colorado Springs, so I've been keeping a close eye on the wildfires through the #nws website.  URL	Affected individuals
High Park Wildfires Whip Through Colorado URL	Other Useful Information
@BasedBieberLife VIDEO: Australia declares fire emergency: Australian officials have declared a state of emergency in New S...  @deadmau5	Caution and advice
RT @LenkaMusic: Horrid bush fires in NSW. Feeling for all those affected. The air smells like burnt eucalyptus even where I live...	Sympathy and support
RT @NSWRFS: Commissioner: Use today to prepare. Use tonight to check your Bush Fire Survival Plan. #nswfires #NSWRFS URL	Caution and advice
@GarcelleB Pls spare a thought/prayer for the brave men and women on the front line of the #nswfires #asbadasitgets #prayforrain	Sympathy and support
People of NSW, be careful because there's fires spreading! Stay safe everyone! URL	Other Useful Information
This is crazy #highparkfire URL	Other Useful Information
RT @702sydney: Image of @LindaMottram w/ General Manager of the Zig Zag railway, Michael Forbes next to a burnt carriage #nswfires URL	Affected individuals
RT @coloradoan: #HighParkFire UPDATE: Re-Evacuations being announced for Hwy 14, east of Seaman Reservoir.	Caution and advice
Australia fire threat 'averted' URL	Other Useful Information
RT @NSWRFS: The Rural Fire Service (NSW RFS) can confirm the crash of an aircraft a short time ago, west of Ulladulla. Details - URL	Infrastructure and utilities
RT @denverpost: ALERT: 29 homes ordered to evacuate due to #FlagstaffFire near Bison Drive in Boulder: URL	Infrastructure and utilities
57 fires scorch eastern Australia: At least 57 bush fires are raging in eastern Australia, including 14 that a... URL	Caution and advice
High Park Fire 2012: Colorado Blaze Burns Record Number Of Homes: DENVER -- Additional crews were arriving Satur... URL	Infrastructure and utilities
Firies to link two Blue Mountains Fires: A desperate backburning operation in the NSW Blue Mountains is underway... URL	Other Useful Information
#news 57 fires scorch eastern Australia: At least 57 bush fires are raging in eastern Australia, including 14 ... URL	Other Useful Information
For all the latest on the fires in Colorado springs go to URL  URL #WaldoCanyonFire URL	Other Useful Information
RT @HumaneSociety: Crystal Mtn Road, Upper Buckhorn, leave NOW! Take pets! Burn pattern of #HighParkFire could cut off exit via @Larimer ...	Caution and advice
Wildfires in Colorado and New Mexico ravage thousands of acres of forest and cause massiv... URL + URL	Other Useful Information
RT @ralphprovance: RT @Ten4Ministries: Join in praying 4 the 1st responders in Colorado &amp; specifically the Colorado Springs area as  ...	Sympathy and support
RT @Reuters: Monster Colorado wildfire rages; Obama plans visit URL	Other Useful Information
RT @Alex_Ogle: Photo of wildfire raging behind Air Force Academy in Colorado - URL by @Zakary via @nycsouthpaw	Other Useful Information
To all the Emergency crews in Colorado Springs. Be Brave and Godspeed! It is hell there right now. #firebrea URL	Sympathy and support
NSW Rural Fire Service @NSWRFS spokesperson Joel Kursaw just told @RNDrive the fire season may be longer now. #nswfires #auspol #climate	Caution and advice
Colorado Springs fire evacuation area expands, as Boulder braces URL	Other Useful Information
@ninatypewriter we've avoided the Colorado-style wildfires (too wet) And no derecho (so far)	Other Useful Information
Thanks for the RTs @mayread3 Maria, appreciate your support. Needs ongoing. #HighParkFire #smday URL	Sympathy and support
RT @nswfire: #nswfires status 11:45 URL Fire #advice #mountyorkroad 06:05 #linksviewroad  06:04 #hallroadfire 06:02 #how‚Ä¶	Other Useful Information
Colorado wildfires URL	Other Useful Information
RT @KyleLSaunders: Just some perspective: 14000 acres = 21.87500 sq mi #highparkfire; @LarimerSheriff notes still 0% containment--so sco ...	Infrastructure and utilities
Where exactly are the fires? #nswfires	Other Useful Information
Thoughts are with those around the fires. Stay safe. #nswfires	Sympathy and support
RT @channeltennews: If you need to stay up to date with bushfire conditions ‚Äì make sure you also follow @NSWRFS on twitter. #SydneyFires #n‚Ä¶	Caution and advice
Colorado Wildfire Causes Hotel Closures &amp; Chaos as 32,000 Residents Evacuate URL	Affected individuals
RT @DarknessRadio: Lord please bring the driving rain to Colorado to stop the horror that is taking place there. End the fires &amp; sav ...	Sympathy and support
RT @DaniIsdale: Leaving the newsroom now, thinking of all the #nswrfs volunteers who will keep working all weekend to save houses and lives‚Ä¶	Sympathy and support
BIG Colorado Thank You to @Good4UDrinks for sending more drinks to the frontline.  #HighParkFire URL	Donations and volunteering
RT @KDVR: Pre-evacuation notice for the city of #Boulder URL #flagstafffire	Caution and advice
Starting to rain lightly on the ranges here in Canberra ... hope this is also happening further north over the fires #nswfires	Other Useful Information
RT @NSWRFS: Thank you to the thousands of firefighters who have so bravely fought fires in difficult conds. #NSWRFS #nswfires URL	Sympathy and support
Fire threat to Australia's Blue Mountains 'averted' - BBC News: Sydney Morning HeraldFire threat to Australia'... URL	Other Useful Information
RT @Y7News: Two girls charged with deliberately lighting Sydney fire. URL	Affected individuals
Wildfires Blaze in Colorado, Threaten US Air Force Academy:  URL	Other Useful Information
RT @robrfs: Fire up on Putty Road even on benign weather day #nswfires URL	Infrastructure and utilities
Colorado wildfire: Winds whip flames; 32,000 ordered to evacuate URL	Affected individuals
RT @news_com_au: MORE firefighters have been recruited to help fight a raging wildfire in the western US state of Colorado, which... htt ...	Other Useful Information
We are sending our positive thoughts to all who are affected by the fires in our beloved home state of Colorado.	Sympathy and support
I can't believe my city is burning down as we speak .... i love colorado Springs :( I dont want to have to evacuate ...	Affected individuals
RT @thisblondekid: I always said I hated Colorado Springs... but it is such a beautiful place and this is so tragic. #prayforcolorado	Sympathy and support
Smokey mist covers the skies of Sydney from the bush fires. #sincity #nswfires URL	Other Useful Information
AUSTRALIA: Australia merges  blazes to prevent ‚Äòmega-fire‚Äô: Firefighters battling unseasonable wildfires in so... URL	Other Useful Information
Record hot year causes fire emergency in Australia: The hottest 12 months on record in Australia have resulted... URL	Other Useful Information
RT @denverpost: How to assist Colorado #wildfire victims, how to donate and help: URL #highparkfire #waldocanyonfire	Donations and volunteering
RT @NSWRFS: If you find an injured native animal, call WIRES 13000WIRES or DPI for livestock.  URL @WIRES_NSW #nswfires	Donations and volunteering
UPDATE: 64 fires burning, 24 uncontained. Dropped temperatures but strong winds. Authorities warn: #nswfires crisis is far from over #today9	Caution and advice
RT @james_willstrop: Whilst the floods cause havoc in Yorkshire, Colorado is burning. Wild fires are closing in on Estes Park! Desperate ...	Other Useful Information
.@deadmau5 Australia Fires: Military Investigates Blaze: The military reveals it was conducting an explosives trainin...  @THEKINGColucci	Other Useful Information
@NSWRFS: Media release from CASA warning people to keep 'drones' off fire grounds URL #nswfires @DozerTweet	Caution and advice
Forest fires in Colorado! #awful URL	Other Useful Information
RT @MertAran5: URL fasil ekibi  #nswfires	Not applicable
Waldo Canyon fire near Colorado Springs reaches 98 percent containment URL via @denverpost	Other Useful Information
A Declaration of state of emergency for #NSWbushfires by @barryofarrell - STATE EMERGENCY AND RESCUE... URL	Caution and advice
RT @RebelWilson: Thinking of everyone in Western Sydney who are being affected by the bush fires x be safe x	Sympathy and support
RT @BrendanChristie: Packed out hall at Blaxland High Community Meeting #bluemountains #nswfires URL	Other Useful Information
VIDEO: Colorado wildfire 'moving fast' URL	Other Useful Information
RT @kmitchellDP: Colorado wildfire: some residents defy evacuation order for #highparkfire. URL	Affected individuals
There are numerous serious fires going on in Colorado and a heat wave that isn't helping. Pray for rain! People are losing their homes. :(	Sympathy and support
RT @USNationalGuard: Air #NationalGuard firefighting C-130s shifted from Colorado to Wyoming, battle wildfires in South Dakota, Wyoming: ...	Other Useful Information
RT @NSWRFS: 4:05pm Media briefing with Commissioner Shane Fitzsimmons being live streamed now - URL #nswfires #NSWRFS	Caution and advice
#waldocanyon fire....Views from my parents neighborhood....they have evacuated. I did steal these photos fro URL	Affected individuals
RT @Shutterbug_1984: #repost #nswfires @NSWRFS #bushfires #bushfire URL	Other Useful Information
RT @denverpost: We created a perimeter map of the #FlagstaffFire from data posted to GeoMAC earlier today: URL	Other Useful Information
RT @cnnbrk: Officials: At least 57 bush fires rage in Australia; state of emergency declared URL	Caution and advice
RT @cnnbrk: Officials: At least 57 bush fires rage in Australia; state of emergency declared URL	Caution and advice
RT @GusWhyte: The fires in Eastern NSW makes me very sad, I feel for all the ppl impacted, I can only imagine how frightening it would be i‚Ä¶	Sympathy and support
Thanks to #nswrfs 4 doing an incredible job of keeping the Hume Hwy open today. Back to the #2UE newsroom 2morrow 4 more #nswfires coverage	Other Useful Information
My prayers go out to the people who have lost everything in fires in Colorado. Hopefully they burn out soon !	Sympathy and support
RT @ABCCentralWest: RFS 1105 update: Winds are picking up. Some helicopter water bombing has been suspended due to high winds. #nswfires	Other Useful Information
Hearing sad news the little prawn on the A43 at Crangan Bay (west of Catherine Hill Bay) has gone up in flames. #nswfires	Sympathy and support
Colorado wildfires worsen, 32,000 flee homes URL via @reuters	Affected individuals
RT @JezFernandezABC: It's just terrific seeing Auslan translators as a normal component of emergency mgmt procedures. Very smart. #nswfires.	Other Useful Information
RT @taytayphil: Man these fires are just heartbreaking. Save beautiful Colorado and beautiful people.	Sympathy and support
Where can I donate to wildfire relief in Colorado?	Donations and volunteering
RT @jawtry: RT @runnermwilliams: SW side of Ft Collins. It's like a scene from Independence Day. #highparkfire URL	Other Useful Information
RT @ScubaGuev: Whoever is starting these fires in Colorado needs to die	Other Useful Information
URL Army criticised over Australia fire: Australia's military faces criticism after it is bl... URL	Other Useful Information
CURRENT TEMP in Colorado Springs is 95 degrees. #WaldoCanyonFire	Other Useful Information
#fnre #nswbushfires Regular bushfire updates available through NSW RFS URL URL	Caution and advice
All these bush fires in NSW make me appreciate living in Brisbane. Although I have the threat of floods‚Ä¶‚Ä¶	Sympathy and support
Current Colorado Fires Map from Colorado Division of Emergency URL #COLORADOFIRE #COLORADOFIRES	Other Useful Information
RT @9NewsSyd: Insurance companies are paying over $2 million a day for victims of the recent #nswfires disaster. Read more: URL	Other Useful Information
@TripleMSydney thank you for the excellent coverage of the #nswfires this along with great music is why i listen to the M's :-)	Sympathy and support
What #fire scientists say: Australia's bushfire weather is getting worse, fire danger index rising in SE Australia URL	Caution and advice
colorado fire: ... URL	Other Useful Information
The skycrane working through the smoke at #faulconbridge Image l John Donegan URL	Infrastructure and utilities
Why isn't our superman PM fighting the NSW fires? He can for his claim volunteering as well. #auspol	Donations and volunteering
Well,his putting has been off RT @MelissaTweets: Why doesn't President Obama care about Hurricane Katrina? I mean the Colorado wild fires?	Other Useful Information
@Sim_One76 Are any of the group near the fires Simmy? Is it just in one State..NSW?	Other Useful Information
Thinking of the people and wildlife right now at beautiful #nordswharf #nswfires URL	Sympathy and support
State Mine: Photo from Mountain Lagoon Rd taken by Hawkesbury Gazette URL #nswfires #NSWRFS	Other Useful Information
Colorado wildfires: Real-time social media response map URL via @denverpost	Other Useful Information
RT @anwyn: If you're wondering why NSW is freaking out right now, this is what our state looks like: each diamond is a fire URL	Other Useful Information
'Firestorm of epic proportions' | proportions, waldo, canyon - WALDO CANYON FIRE - Colorado Spring.. URL	Other Useful Information
RT @DenvNuggetsnews: LIVE VIDEO: Waldo Canyon Fire in Colorado Springs - URL URL	Other Useful Information
In Focus - Colorado Wildfires: The Aftermath - The Atlantic URL	Other Useful Information
@LetMeBeYourLove you'l be fine love . hopefully , you wont be in Colorado Springs cus they got that wild fire down there .	Sympathy and support
Australia fire threat eases as military blamed URL	Other Useful Information
Simone Covey, Waldo Canyon Fire Evacuee, Settles In At A Colorado Shelter (PHOTOS): COLORADO SPRINGS... URL #yavaughnie	Other Useful Information
RT @NSWRFS: Watch &amp; Act - Linksview Rd, Springwood Four local schools closed tomorrow URL #nswfires #nswrfs	Infrastructure and utilities
RT @9NEWS: BREAKING: new #COFire near Platteville, Weld Co CR32 &amp; CR35, there are evacuations PIC from Allyson Kulinski  URL ...	Affected individuals
Front page shocker: A Colorado family learns - in a shocking way - that their home has been lost to fire. CNN's ... URL	Affected individuals
Waiting for the fire front - asset protection duty #nswbushfires URL	Affected individuals
Wild fires in colorado serious right now	Other Useful Information
RT @DCCOeXaminer Private use of fireworks banned throughout Colorado due to extreme fire danger: Gover... URL #examiner	Caution and advice
PRAYING.. RT @leighramsey: Colorado Fire: Worst in 32 yrs. Perfect storm apparently. 32 thousand being evacuated URL	Affected individuals
@ashergrey @NWSSaltLakeCity #ConnecttheDots #utheat &amp; #wildfire fueled by climate change URL	Other Useful Information
@NSWRFS Have their work cut out for them today &amp; for the rest of the season. Thank you to all involved &amp; helping out. Stay safe. #nswfires	Other Useful Information
Australia bush fires menace New South Wales homes: Scores of bush fires blazing in Austra... URL #teamfollowback #jfb	Other Useful Information
RT @newscomauHQ: For more information on NSW fires please call 1800 679 737 or visit the @NSWRFS Facebook page. #nswfires #bushfires | URL	Caution and advice
For the Santa Messa tomorrow a special prayer for all who have already lost their homes in our bush fires in Australia dear Papa Francesco	Sympathy and support
RT @NSWRFS: Emergency Warning: Linksview Rd, Springwood  URL #nswfires #nswrfs	Caution and advice
RT @MFB_NEWS: @GrantOConnor1 A mix of MFB and CFA fire crews, equipment and personnel have been deployed to assist with the #nswfires	Donations and volunteering
Colorado State University classes disrupted by High Park Fire  URL	Other Useful Information
The fire has offically reach the city of Colorado Springs. Please be praying. URL	Sympathy and support
RT @smh: Editorial: Bushfire disaster reminds us we are one community. URL #nswfires	Other Useful Information
RT @paterosbrew: #HighParkFire fundraiser THIS SATURDAY, from 11-2. With @TheWaffleLab and many others, so stay tuned for more details.	Donations and volunteering
Our shelter team arrived in Colorado early this morning &amp; has been transferred to Divide, CO to assist with wildfire evacuees in that area	Donations and volunteering
Wildfires threaten Sydney: More than 70 fires are raging across Australia's most populous... URL #atlantacash4junkcar	Other Useful Information
Colorado wildfire: Obama departs Colorado Springs, mayor reflects - The Denver Post URL	Other Useful Information
RT @SheilaWalsh: Praying for divine intervention  and protection for all those affected by the fires in Colorado Springs. #waldocanyonfire	Sympathy and support
Latest on the #nswfires here URL	Other Useful Information
@bigshow81 was good mart, how was yours? Mark Bosnich was on talk sport he reckons u can smell the bush fires in Sydney ?	Other Useful Information
RT @bigbooty_JUDYYY: Prayers go out to everyone affected by these wildfires in Colorado! The Lord is the ultimate protector, trust in Him.	Sympathy and support
@jolantheerb Horrible fires. Colorado Springs is being evacuated. #beechrt	Affected individuals
Meanwhile, all of Colorado is on fire and the Rocky's received 2 percent of its usual snowfall. But climate change is a myth.	Other Useful Information
Branches in the Blue Mtns are open today with full services-staff ready to help. Thanks to all who have bravely helped during the #nswfires	Other Useful Information
Colorado wildfire: Tankers resume fighting 52000-acre High Park fire - Denver Post: Fox 31 KDVR.comColorado wild... URL	Other Useful Information
Colorado Springs POLICE are closing PALMER PARK as a PRECAUTION ONLY!!!!! #WaldoCanyonFire	Caution and advice
Top Story: Australia bush fire threat easing: Wildfires threaten the western suburbs of Austral... URL #ERMmedia @CNN	Infrastructure and utilities
@GerardKapraun 125 (IBD) Al Gore Throws Another Climate Lie On The Barbie - Blames Australia Fires On Climate Change URL	Other Useful Information
RT @triplejHack: We're talking about whether it's too early to blame climate change for the #nswfires. Are you worried these are happening ‚Ä¶	Other Useful Information
RT @gregstier: Northwestern Colorado Springs is in imminent danger from the wind-driven inferno. Please pray. Houses are burning &amp; t ...	Sympathy and support
EMERGENCY WARNING - #rfsnsw maintain emergency warning for Bell, Dargan, Clarence &amp; Bilpin URL #nswfires	Caution and advice
RT @jessicahische: Help support Colorado wildfire victims AND get a rad t-shirt in the process URL	Donations and volunteering
so much fires wtf australia this is horrible	Other Useful Information
RT @dailycamera: Dispatchers: Heavy air tanker now en route to #BisonFire  west of #boulder	Donations and volunteering
RT @abcnews: The UN says the NSW fires are an example of the doom the world may face without action on climate change. URL	Other Useful Information
Best wishes to all in NSW tonight, stay safe! #nswfires URL	Sympathy and support
#GreenTweets: Colorado wildfires explained  low snowpack leads to blazing summer URL	Other Useful Information
#colorado Colorado Springs wildfire forces more than 32000 from homes as it ... URL	Affected individuals
RT @fosterthepeople: ‚Äú@fosterthefuture: fans helped us raise $15,830 for the Colorado Wildfire Relief Fund last night at Red Rocks. Spee ...	Donations and volunteering
RT @tracysolomon: PHOTOS: View aerial images of the #WaldoCanyonFire in Colorado Springs: URL #cofire	Other Useful Information
It seems yet again significant chunks of NSW are on fire. URL - Racing my bike in Kanangra Boyd NP this weekend. Eeek.	Other Useful Information
RT @COEmergency: #HighParkFire Disaster Recovery Center opened this morning at CSU Johnson Hall to bring together resources. URL ...	Donations and volunteering
Crisis Averted For Now In Australia's Fight Against Fires URL	Caution and advice
@Maria_Savva Great thanks, although the air in Sydney is thick with smoke from the bush fires. Hope you are well.	Sympathy and support
RT @SkyWeatherAUS: via @Samdawson01: Live at @NSWRFS headquarters 'the worst fire emergency NSW has seen in over a decade' RFS @SkyNewsAust‚Ä¶	Other Useful Information
RT @NSWRFS: #NSWRFS &amp; #FRNSW crews on scene working to contain a fire at Parbury Park (Lake Macquarie), near the Old Pacific Highway, Swans‚Ä¶	Other Useful Information
RT @PeterDoherty7: The Queenslanders are on their way to help New South Wales #nswfires @7NewsBrisbane URL	Sympathy and support
RT @GilComMedia: Amid historic wildfires, Twitter becomes go-to news source -  @GroundFloorPR URL #flagstafffire	Other Useful Information
Please keep my family, as well as the other families that had to evacuate the Colorado Springs area due to forest fires, in your prayers	Sympathy and support
Boise Firefighters Battling Colorado Wildfires: Members of the Boise Fire Department are on... URL #News #US #Idaho #ID	Donations and volunteering
RT @MalloryOnTravel: Colorado Springs Fire Spreads to Tourist Areas: Pikes Peak, Rocky Mountain Park URL #travel #ttot	Infrastructure and utilities
RT @benloiacono: Cigarette butts cause #bushfires. Please bin your butt! #hillsdistrict #SydneyHills #NSWRFS	Caution and advice
RT @ABCNews24: Shane Fitzsimmons: Our focus today is the Bells Line of Road, particularly to the west of #Bilpin #nswfires #bushfires	Other Useful Information
Faces of the #NSWfires: personal stories from people affected and those offering help URL #knowthestory	Other Useful Information
RAIN ALREADY #COLORADO.  It looks like Armageddon over there.  #flagstafffire	Sympathy and support
Smell of Ash in Sydney  is a reminder of how close we are to the fires . My family home burnt down in 1980 so understand the trauma#fires	Affected individuals
2 wildfires in Boulder County. We can see smoke to the north.	Other Useful Information
India Large wildfire in N. Colorado prompts evacuations URL	Affected individuals
News Update Furious Wildfire in Colorado Leaves Destruction in Its Wake URL	Infrastructure and utilities
its a shame Colorado couldn't have all this rain :( #wildfires	Other Useful Information
RT @BronwynHemsley: ! RT @702sydney: Another photo of the @NSWRFS firefighter crawling out of flames at #faulconbridge backburn #nswfires h‚Ä¶	Affected individuals
RT @larryemdur: Dear pathetic arseholes  looting houses in NSW fire zones .. You are disgusting pieces of shit !!!!	Sympathy and support
'Mega-fire' fears in Australia URL	Other Useful Information
#Colorado fire victim films her own evacuation URL	Affected individuals
Colorado. Soon to feature plagues of locusts.: First, the big fire came.   Then, the firefighters arrived to fig... URL	Other Useful Information
RT @TammyBarber: Lord, protect those in the path of the fires in Colorado. Please, send your Divine extinguisher for those fires!	Sympathy and support
LetYouKnow: Australia fire threat 'averted': Australian fire officials say the threat t... URL URL	Other Useful Information
The Flagstaff fire is one ridge away from entering Boulder. :(   URL	Other Useful Information
RT @NSWRFS: Total Fire Bans will be in place in a number of areas tomorrow including Greater Sydney, the Greater Hunter, and the Illawarra/‚Ä¶	Other Useful Information
RT @abcnews: #breaking: Air Marshall Binskin apologises on behalf of Defence after confirmation live fire exercise linked to #nswfires	Other Useful Information
RT @NSWRFS: Stockrington Rd Fire: The M1 has reopened southbound. Northbound lanes remain closed. #nswfires #nswrfs	Infrastructure and utilities
RT @PleasureEllis: Colorado Wildfires Seen From Space: Big Vid: A video released by NASA shows huge plumes of smoke billowing up in... h ...	Other Useful Information
RT @smh: @NSWRF Reminder: do not call Triple Zero just to report smoke. Save it for people who need it in an emergency. #NSWRFS #nswfires	Caution and advice
RT @boulderparksrec: Open water swim at the reservoir cancelled tomorrow (6/27) due to smoke in the area. #FlagstaffFire	Caution and advice
RT @CFA_Updates: Share a message of support for the people and communities affected by the #nswfires on the @Fed_Square big screens by usin‚Ä¶	Sympathy and support
A.M. BEST:Major Insurers Establish Claims Centers Near Raging Wildfires Outside Two Colorado Cities               URL	Other Useful Information
@Mizz_M This is is for the fire affected areas in NSW. Apologies for any confusion. There are no silly questions:) ^SD	Other Useful Information
Of course it did. RT @drgrist: My new post: Did climate change ‚Äôcause‚Äô the Colorado wildfires? URL	Other Useful Information
RT @BSidesNarrative: If you pray, pray. If you think, put'em in your thoughts, but send some love to your friends in Colorado Springs. T ...	Sympathy and support
RT @abcnews: Watch and Act warning issued for a fire near Mount York Road at Mount Victoria in the upper Blue Mountains #nswfires URL	Caution and advice
RT @WSJ: A Colorado fire forced 32,000 residents to evacuate. It doubled in size overnight to 24+ square miles. Photos: URL	Affected individuals
Flames Encroach on Colorado Springs: Some of our viewers in Colorado Springs sent us their pictures of the fire ... URL	Affected individuals
RT @CastleDarryl: If Slim Dusty was still with us I reckon he'd write a song called Fighting fires with your beer #nswfires URL	Other Useful Information
Photo | The @RBB_net show a sign of respect to the victims of the NSW fires. #GoWanderers #aleague URL	Sympathy and support
Before and after satellite images showing the extent of the #nswfires URL	Other Useful Information
RT @JoViClo: God Bless those who serve others. #firefighters in #Colorado, stay safe. URL	Sympathy and support
RT @australian: Fears grow blazes will form 'mega-fire': NSW fire chiefs are growing increasingly worried major bushfires in t... URL	Caution and advice
Sydney CBD skyline, shrouded in smoke, blue skies reflected in the glass of the buildings. #nswfires #bushfires URL	Other Useful Information
@jimsrer ‚Äú@BuzzFeed: Over 32,000 people were evacuated last night from the path of the Waldo Canyon fire in Colorado URL	Affected individuals
See state of emergency declared in NSW because of bush fires - hope you are OK!	Caution and advice
Volunteers are amazing - &amp; some of Australia's best are out fighting one of Australia's biggest fires today in... URL	Sympathy and support
High Park Fire: Kansas &amp;amp; Nebraska National Guards Support Colorado URL via @youtube [Like it? URL ]	Donations and volunteering
RT @TheMcJagger: This is Colorado Springs...Unbelievable. It looks like a nuclear bomb went off. URL	Affected individuals
Obama in Colorado to tour state‚Äôs worst-ever wildfire ‚Äì Chicago Tribune: CBC.ca Obama in Colorado to tour state'... URL	Other Useful Information
RT @VaSarver: Yall complaining about no power and ac and the people in Colorado losing their HOMES and LIVES to fires. #bethankful	Sympathy and support
390 #HighParkFire evacuees  told they can return home Wednesday URL	Affected individuals
#boulderfire viewed from NCAR. Flames were visible at ridge but air drops seem to be preventing rollover into canyon. URL	Other Useful Information
RT @therealmalcolm: Yo Australia send my prayers hope people are safe from the fires @MKTOAustralia	Sympathy and support
RT @kumitaguchi: In case I'm sent to the bushfires, grab bag preparation #firstaid #water #food #nswfires URL	Affected individuals
RT @geehall1: Twitter list of important Emergency Services and other important Twitter feeds in #NSWfires:  URL #sydneyf‚Ä¶	Caution and advice
RT @denverpostjoe: Lots of action in the newsroom. The #waldocanyonfire is getting much worse. #cofire	Other Useful Information
@deadmau5 Australia Fires: Military Investigates Blaze: The military reveals it was conducting an explosives training...  @THEKINGColucci	Other Useful Information
Fire evacuation sparks panicked pet exodus - When evacuation orders came at 3 p.m. last Tuesday in Colorado Springs,... URL	Affected individuals
@TaycoEast Please RT! Help My Friends in CO .Great way to help support Colorado Fire ... URL thanks!  @WilliamFederico	Donations and volunteering
@BasedBieberLife VIDEO: Australia declares fire emergency: Australian officials have declared a state of emergency in New S...  @deadmau5	Caution and advice
RT @NSWRFS: Watch and Act - Hall Road (Southern Highlands / Wollondilly).  URL Picton Rd now open #nswrfs #nswfires	Caution and advice
@BasedBieberLife Australia fire threat 'averted': Australian fire officials say the threat to the Blue Mountains west of Sy...  @deadmau5	Caution and advice
RT @AGWobserver: Divergent responses of fire to recent warming and drying across south-eastern Australia URL	Other Useful Information
RT @NSWRFS: Media release - Total fire bans until further notice - URL #NSWRFS #nswfires	Caution and advice
RT @stevelange: Plz RT How 2 help those affected by the CO fires: URL #waldocanyonfire #flagstafffire #highparkfire	Donations and volunteering
Colorado fire: 41,140 acres burned, 1 dead: Firefighters were hoping to get control Tuesday of a fast-moving wil... URL	Affected individuals
RT @denverpost: #HighParkFire, at 14,000 acres (22 sq. miles), is roughly the same size as the city of #Boulder (24 sq. miles): URL ...	Other Useful Information
RT @wildfiretoday: I-70 is now CLOSED from exit 49 to exit 62. Alternate route is the Debeque Cutoff to Hwy 65 #COfire #pineridgefire #gjco	Infrastructure and utilities
RT @atmosphere: our thoughts go out to the people in colorado dealing with the wildfires.	Sympathy and support
RT @cbemergency: WOW! RT @nswfire: #nswfires Amazing #stateminefire   URL URL	Other Useful Information
RT @heldavidson: 'The environment minister said he looked up what wikipedia says about bushfires'... #auspol #nswfires	Other Useful Information
RT @PMOnAir: Adam Bandt is a disgrace. I can't think for a more inappropriate tweet. #nswfires #sydfires #pmlive  URL	Other Useful Information
RT @RMACCFireinfo: Tanker update: 6 pm, 37 drops, 58,557 gals retardant on #HighParkFire from #JeffcoAirTankerBase.... URL	Other Useful Information
Another game pitching and it's raining I thought I was getting away from the rain!!!!!! Your welcome Colorado I'm here to help your fires	Other Useful Information
Sunset I shot last April on top of Buckhorn Mountain, at #ShilohGuestRanch, now under #HighParkFire.  URL	Other Useful Information
RT @BrettMasonNews: Ash and charred leaves from Blue Mountains fires falling near Coogee Beach in Sydney's East #bushfires #nswrfs URL	Other Useful Information
Interesting... Colorado wildfire destroys hundreds of homes URL	Infrastructure and utilities
Army criticised over Australia fire: Australia's military faces criticism after it is blamed for starting one ... URL	Other Useful Information
RT @TripleMSydney: Can you help home pets/animals in need of temporary homes? #nswfires NARGA volunteers would like to hear from you URL	Donations and volunteering
Yesterday's firefighting aircraft crash was the fourth fatal accident involving an M18 Dromader since 2006 URL #nswfires	Infrastructure and utilities
#NSWFIRES  NE of Mount Coramba, Type: Bush fire, Status: Out of Control, Size: 1 ha, Map: URL URL	Caution and advice
RT @anotabletweeter: RT @lakalt: @robertirvine1 @chefsymon @altonbrown @Bourdain Colorado Springs is on fire!  Tens of thousands forced  ...	Affected individuals
What a terrifying picture. RT @timring3TV: Breathtaking photo outside the Air Force Academy in Colorado Springs. URL	Other Useful Information
Defence apologises for starting massive State Mine fire - Sydney Morning Herald URL	Other Useful Information
Western wildfires forcing evacuations: Firefighters in Colorado and New Mexico are battling wildfires that are m... URL	Other Useful Information
RT @unisdr: 17 Oct NASA image gives an idea of the scale and extent of the bush fires raging in New South Wales #australia URL	Other Useful Information
@BiancaGriffith #boulder #FlagstaffFire Esto es de Pel√≠cula Americana... URL	Other Useful Information
hoping some rain hits colorado and puts out the fires, especially before it gets to friends at the Air Force Academy #USAFA	Other Useful Information
RT @702sydney: Needing info on school closures for today? Full list available here: URL #nswfires	Caution and advice
RT @denverpost: LIVE: View photos shared on social media of the #WaldoCanyonFire: URL #CoFire	Other Useful Information
More than 32000 ordered to flee Colorado wildfire - USA TODAY: USA TODAYMore than 32000 ordered to flee Colorado... URL	Affected individuals
RT @abcnews: #Breaking: A state of emergency is declared in NSW by Premier Barry O'Farrell. Live: URL #NSWfires	Caution and advice
RT @9NEWS: #HighParkFire press conference: 20,000 acres, 0 containment, Type 1 Incident Command takes over tomorrow	Infrastructure and utilities
RT @miraclady DID YOU START THE FIRES IN COLORADO? Are you sure? URL	Other Useful Information
RT @dbouwman: Pretty smoke free day Fort Collins, but the smoke is settling in now... closing windows! #highparkfire	Affected individuals
Fires spread to Colorado tourist centers: Wildfires moved in on some of Colorado's most popular summer tourist d... URL	Other Useful Information
RT @FireBlogger: Peregrin/Blodgett neighborhood Colorado Springs, no struct. protection. Not enough resources on scene #WaldoFire URL ...	Other Useful Information
RT @KerrinJeromin: Wow. terrible MT @wunderground @SeanSublette13  Terrifying fire in Colorado Springs, CO. Evacuations underway URL ...	Affected individuals
Packed and ready to evacuate if we need to. #WaldoCanyonFire Please pray for the city of Colorado Springs!	Affected individuals
RT @smh: More than 40 cars have been destroyed in a large fire in #Sydney's Olympic Park. URL	Infrastructure and utilities
RT @SebHenbest: Australia has always experienced bushfires, but #climate change is increasing the PROBABILITY of extreme fire days &gt; URL	Caution and advice
RT @BravoAndy: Praying for rain in Colorado! These fires are destroying one of the most beautiful places in America!	Sympathy and support
RT @smh: Do not light fires in the open: RFS warns as #Sydney braces for strong winds and hot weather on Sunday. URL	Caution and advice
Amazing images from the October 2013 New South Wales' bushfires URL #nswfires	Other Useful Information
Its finally raining. I hope it reaches the bush fires #nswfires	Sympathy and support
RT @therealprmoment: Communicator of the Week: Australia's fire fighting Prime Minister, Tony Abbott impresses @edstaite URL	Other Useful Information
NEW! RT @denverpost: ALERT: 32,000 people evacuated in Colorado Springs due to #WaldoCanyonFire: URL	Caution and advice
RT @Robs_au: Lithgow fire from Macquarie Park, Sydney @ndtimes @702sydney URL	Caution and advice
Thousands evacuated as Colorado wildfire nears URL	Affected individuals
Broncos players visit firefighters battling Colorado wildfire URL	Other Useful Information
RT @SamEBJones: Here's what's falling, according to reports, from Springwood all the way to Coogee! (Via b1290, Instagram) #nswfires URL	Infrastructure and utilities
RT @Lisa_Wilkinson: To all the men &amp; women out there today fighting the good fight in the worsening #nswbushfires thank you. Your bravery &amp;‚Ä¶	Sympathy and support
Forest / Wild Fire - Australia - Australia URL	Other Useful Information
‚Äú@nealrogers: Colorado Springs. On fire. Right now. Holy shit. URL went through this twice in San Diego. RAIN! Damn it!	Affected individuals
RT @NSWRFS: Total fire bans are being declared in greater Sydney, Greater Hunter, Illawarra and Central ranges until further notice due to ‚Ä¶	Caution and advice
At least 40 homes destroyed in #SydneyFires #Australia	Infrastructure and utilities
RT @ASNSW: Deputy Chief Executive Mike Willis spoke to Sydney media about the treatment of patients during the #nswfires URL	Affected individuals
This must be where all smoke blanketed Southern #Sydney coming from, even at airport its thick. #nswfires #Bushfires URL	Affected individuals
RT @9NEWS: from URL CO 71 is closed Limon to Brush due to wildfire. Road closure began June 25th, 2012 at 3:41pm. #COFire	Infrastructure and utilities
RT @3AW693: 'The whole of Australia's on fire, is it?': US TV news station's bushfire map misses the mark URL (via @Ross‚Ä¶	Other Useful Information
RT @RobertOvadia: #BREAKING: #NSWFires pilot confirmed dead in crash fighting fires west of Ulladulla. Body yet to be retrieved. RIP.	Affected individuals
@afreedma 1851 was one of the coldest years in the CRU record, and also the year of Australia's worst fire. There is no connection.	Other Useful Information
RT @VicUniResearch: Could #ClimateChange be playing a role in the #NSWfires?: URL	Other Useful Information
NSW National Parks &amp; Wildlife Service have again advised that tomorrow - Sunday 13 October - due to EXTREME fire... URL	Caution and advice
Video: AP  - AP Top Stories: Here's the latest news for Tuesday, June 26: Colorado fires rage in hot, dry condit... URL	Other Useful Information
Fires inflame climate change debate: Australia's bushfires have such a long and destructive history there's al... URL	Other Useful Information
RT @Welsh58: Let's not forget, some fires are down to idiots! As reported Sydney Morning Herald 30 Oct 1951, URL	Other Useful Information
Fire Danger Update - Tomorrow signs will be on VERY HIGH - URL Southern Ranges Region #NSWRFS Permits Suspended	Caution and advice
9 Shocking Twitter Pictures From the Colorado Springs Wildfire URL	Infrastructure and utilities
RT @desstyles: Sydney last week,back there tomo night after show in Brisbane. Fires still look bad though, thoughts go out to everyone ther‚Ä¶	Other Useful Information
57 fires scorch eastern Australia: At least 57 bush fires are raging in eastern Australia, including 14 that a... URL	Other Useful Information
when I was flying into Sydney last night I could see fires burning üò©	Affected individuals
RT @StaceyDales: @CentnerMatt: @StaceyDales 108 here in Pueblo Colorado this week! Plus a huge fire in Colorado Springs! #needrainbads ...	Other Useful Information
RT @phochemrd: @msnbc there is a firestorm in Colorado  springs. #waldocanyonfire are your covering this? @CNN is still several hours be ...	Other Useful Information
God I don't know what's going on... Death of teacher, Pastor Kong in jail, Crazy uncontrollable fire in Colorado. ... ‚Äî URL	Other Useful Information
RT @OwenNix: Sydney International Regatta Centre, doubling as a helicopter refueling station &amp; water source #nswfires URL	Other Useful Information
RT @HumanityRoad: #Colorado Residents sign up county alerts at URL #Redflag warnings #URL #hmrd	Caution and advice
. @NSWRFS not in need of food/blankets -please donate to official sources.Full list can be found at our web #nswfires URL	Donations and volunteering
RT @SeverePlains: #HighParkFire now most destructive in #COFire history, taking 181 homes. Now over 55k acres w/ $10.8M in damage: URL ...	Infrastructure and utilities
#HighParkFire live briefing: Bill Hahnenberg, cmdr: Not the kind of fire where we fight for a couple days and head home. Here a long time.	Other Useful Information
RT @SalArmyEDS: Help #SalvationArmy assist disaster survivors - T.S. #Debby URL &amp; Colorado #wildfires URL ...	Donations and volunteering
'Extreme fire danger' warning - An extreme fire danger warning is issued for the Sydney area. CNN's Robyn Curnow... URL	Caution and advice
RT @TheSmarmyBum: Need a T-shirt? 100% of the proceeds from these go to benefit Colorado wildfire victims URL	Donations and volunteering
RT @dailycamera: Boulder County crews handled two fires started by lightning in foothills west of #Boulder tonight. One in Sugarloaf, on ...	Other Useful Information
RT @HaydosTweets: Final shout out! Thoughts and prayers tonight for the brave folk of #nswfires #GodBless can I request my followers to re ‚Ä¶	Sympathy and support
Sydney Fires Caused by People and Nature URL	Other Useful Information
BREAKING: 11yo boy now charged with lighting fires: URL #NSWfires #sydneyfires #liveblog	Other Useful Information
View from my desk earlier #sydneyfires #sydney #australia #smoke #scary #city #cbd #orange #apocalypse‚Ä¶ URL	Other Useful Information
World gets picture as fire story shared: AS firefighters toil at the black-red coalface, the story of the NSW ... URL	Other Useful Information
Praying for everyone involved with the #nswfires #bushfires please be safe, stay alert and listen to emergency services.	Sympathy and support
#Wildfire @ABC: Record Colorado Wildfire to Be Probed as Possible Arson URL	Other Useful Information
We‚Äôre arranging mobile phones &amp; chargers for those affected by #NSWfires Available from the Penrith Telstra store &amp; soon in Lithgow	Donations and volunteering
RT @bbcweather: Cooler air pushing north across the #bushfire stricken #Sydney area will bring about some showers on Wednesday. StavD URL	Other Useful Information
RT @Idealaw: Firefighters are using Twitter to rapidly map + respond to NSW's bushfire crisis. URL #nswfires	Other Useful Information
RT @ASNSW: NSW Paramedics are urging everyone to take precautions with smoke in the air #nswfires  URL	Caution and advice
the #wildfires in Colorado are out of control! They are across the highway from my friend's apartment... URL	Affected individuals
My thoughts and prayers are with the People and the Fire Fighters in Sydney...	Sympathy and support
RT @ashishpanchal14: Plane fighting Australia fires crashes as cooler weather eases threat - Reuters UK  URL	Other Useful Information
RT @occupySYDNEY: Islamic Relief NSW Bush Fire Appeal - Islamic Relief Australia URL	Donations and volunteering
Is the Colorado Wildfire the Future Norm? URL	Other Useful Information
RT @hillaryrosner: 32,000 people have been evacuated in Colorado Springs, and the NYT home page is still Nora Ephron. I find that upsetting.	Affected individuals
colorado fire fighters can feel the love and support as crowds of people with signs and flags scream an shou URL	Sympathy and support
Airstrip in Colorado Springs.	Not applicable
RT @fbeu: @stuartayresmp You know what's poor form? Cutting the Fire Brigade budget &amp; closing fire stations across Sydney.	Other Useful Information
Raging wildfire most destructive in Colorado's history - CBS News URL	Other Useful Information
These wildfires in Colorado need to stop #favoriteplace	Sympathy and support
New Boulder Fire Prompts Mandatory Evacuations: A fire that erupted in Boulder County Tuesday afternoon -- being... URL	Caution and advice
Wildfires burn across Colorado, thousands evacuated: A spate of wildfires were burning across Colorado on Sunday... URL	Affected individuals
RT @ABCthedrum: The fires in NSW are a devastating reminder of the urgency of action on climate change | Frank Jotzo URL	Other Useful Information
Playing Firey is a nice way of dodging #Auspol Climate questions, thus playing down NSW fires as a national event. URL ‚Ä¶	Other Useful Information
RT @CNNLive: Officials in #Colorado update the status of the High Park #wildfire.  Live: URL	Other Useful Information
says URL Hundreds of homes destroyed in Colorado Springs fire URL	Infrastructure and utilities
This is what the sun looks like in colorado with all the smoke from the fire! #pinksun  URL	Other Useful Information
Hearing structures on Flying W Ranch are now on fire according to @KOAA_5 #waldocanyon sad stuff happening around here right now	Infrastructure and utilities
RT @MickeyFactz Sad Really: I know we not talking about bottle fights... Not when Colorado has wildfires, KKK ... URL	Other Useful Information
KRDO has a live feed up with aerials from the Colorado Springs WILD FIRE   URL	Other Useful Information
RT @JustCindeh: HAHAHAHAHAHA!!!!!!! RT @word_34  Michelle Malkin's mouth is foaming so bad she could almost put out the Colorado wildfires.	Not applicable
@SixlitreHSV tomorrow's conditions predict the worst in nsw history for these fires and there's nothing we can do to help #frustrating	Sympathy and support
Fire and rain tests superintendents: By the time the Colorado wildfire practically arrived a... URL (via @GCM_Magazine)	Other Useful Information
Think and Pray for Colorado Springs Residents- FIRE- it could happen anywhere-Be Prepared!	Sympathy and support
If you're in NSW and are near the fires please stay safe! You all are in my prayers! ‚ù§	Sympathy and support
Australia fires: Firefighters fought scores of bush fires blazing in Australia's New South Wales early Friday. URL	Donations and volunteering
Colorado to double wildfire crews: Officials plan to more than double the amount of fire engines battling the ra... URL	Other Useful Information
A Total Fire Ban has been declared for the Greater Sydney Region on Sunday 13th October 2013 between 12:00am -... URL	Caution and advice
Being able to see the forest fires in New Mexico/Colorado from our hotel #sketchy	Affected individuals
the fires in nsw australia were so terrible, over a hundred house destroyed and i only live 20 minutes away from it all.	Infrastructure and utilities
Def don't miss the bushfires. Hope everyone back home is safe #nswfires	Sympathy and support
RT @abcnews: Stunning images from Sydney and surrounding areas of the #nswfires emergency URL	Other Useful Information
34 fires still uncontained across NSW. Please contact Public Info &amp; Inquiry line if you are concerned: 1800 227 228. #nswfires	Caution and advice
Large wildfire in northern Colorado prompts evacuations - Fox News: CBS NewsLarge wildfire in northern Colorado ... URL	Caution and advice
Saka Water would like to donate a few thousand bottles of Saka Water to the fire fighters in NSW.  Does anyone... URL	Donations and volunteering
@d4_aspen Hey Asp! I have friends who live in Colorado Springs,CO and they are evacuating the city becuz of wild fires. Can you please (c)	Affected individuals
RT @DenverChannel: RT @1310kfkanews: @larimersheriff just told 1310 KFKA the acreage of the #Highparkfire may grow significantly today	Other Useful Information
RT @850KOA: Devasting update from #HighParkFire.  112 homes lost.  More likely to be counted in the coming days.	Infrastructure and utilities
RT @TimothyWhalin: The #WaldoCanyonFire has increased to 15,324 acres. Please continue to pray for Colorado Springs.	Sympathy and support
Lord please watch over Your people over in Colorado who are havin a very difficult time with these wildfires. Please take care of em.	Sympathy and support
Surging Colorado wildfires forcing tens of thousands to flee  URL	Affected individuals
RT @meggrieve: Poetic. #highparkfire  URL	Other Useful Information
RT @ExamineDisaster: @NASA releases stunning bird‚Äôs eye view of Colorado‚Äôs wildfires, fires in NM &amp; UT: URL #HighPa ...	Other Useful Information
Hundreds of Homes Destroyed in Colorado Fire: Colorado Springs officials say hundreds of homes have been destroy... URL	Infrastructure and utilities
Colorado Springs, CO is on fire. 65mph winds blew it into the city today. Looked like Armageddon. URL	Other Useful Information
Wed Night:Wednesday Night Mostly cloudy,Low around 66.Southwest wind 5 to 7 mph be safe &amp; smart #Utah #4thOfJuly #fireworks #Wildfire	Not applicable
Sunset + High Park Fire = Intense Picture. #highparkfire #fortcollins URL	Other Useful Information
RT @tryonb: Chapel Hills Mall in Colorado Springs will offer an evacuee lounge beginning Thurs. More on URL #WaldoCan ...	Other Useful Information
Hoping this is over soon for all concerned. #nswfires	Sympathy and support
RT @darinsullivan09: #FIRE PHOTO: most days #FRNSW fire stations shut in NSW under O'Farrell fire budget cuts. #NSWPOL #cutscostlives URL	Caution and advice
Beyond the trauma of losing a home, the #HighParkFire is going to take a chunk out of property tax revenue. URL	Infrastructure and utilities
Rolling #nswfires coverage #nswfire updating URL #breakingnews URL #australians URL	Other Useful Information
RT @Petsupdate1: Colorado Springs community welcomes evacuee pets - URL powered by KVII URL	Other Useful Information
I've figured out why Colorado is on fire. Al Qaeda hacked the CIA weather control satellites using a virus that was implanted in Osamas DNA	Other Useful Information
Stop Tony Abbott fanning the flames of climate change. Sign now #nswfires URL	Other Useful Information
Current estimate for #HighParkFire is 41,140 acres. They will know more in the morning after a night IR picture is taken.	Other Useful Information
#newbedon 6/28/2012 9:25:11 AM Colorado fire near Pike's Peak forces 11,000 from homes URL	Affected individuals
RT @dhorning11: RT @LarimerCounty: #HighParkFire burn area map as of Monday night 10 p.m. URL	Other Useful Information
Colorado's most destructive fire nears containment [URL URL	Other Useful Information
'Miracle' if NSW fires don't kill: premier via @Y7News URL URL	Other Useful Information
RT @Sean_Waldron: Friends, it has been declared a disaster in colorado springs due to the fire. Prayers are needed! Send em up for the c ...	Sympathy and support
RT @weirdaustralia: Last October near Blackheath in the Blue Mountains #nswfires URL	Caution and advice
RT @NSWRFS: NSW Governor Marie Bashir has visited #NSWRFS HQ, passing on her thanks to the thousands of firefighters #nswfires URL	Sympathy and support
RT @kenmarlewski: Pretty serious fire situation in NSW #nsw #fires #SydneyFires #sydney URL	Caution and advice
Lithgow bushfires #nswfires URL	Other Useful Information
Five police officers in Blue Mountains were fighting fires and evacuating residents while their own homes were burning down. #nswfires	Donations and volunteering
RT @ExaminerWeather: #HighParkFire explodes to 36,930 acres, 400 personnel on site, more evacuations ordered. Story &amp; photos: URL ...	Affected individuals
Thinking of my bestie in colorado.. So many wildfires and not the latest one is close to her house and work. üò≥üíî	Sympathy and support
RT @AnaCabrera: #HighParkFire latest: 52,000 acres, 15% contained, at least 48 homes destroyed, 200new evacs overnight in Glacier View area.	Infrastructure and utilities
Wind, Heat Hamper Colorado Wildfire Fight: Wind, Heat Hamper Colorado Wildfire Fight	Other Useful Information
Fire warning issued for NSW south coast URL	Caution and advice
RT @nswfire: #nswfires A picture tells 1000 words  Your pics of #firefront &amp;/or #smokeplume help @nswrfs fight #nswfire Email to: photos@rf‚Ä¶	Other Useful Information
‚Äú@smh: A blood red sky over Tom Uglys Bridge in south Sydney. Photo: Chris Lane. #nswfires URL - RT - Amazing!	Other Useful Information
RT @CNN: 56 fires scorch eastern Australia; state of emergency declared: URL	Caution and advice
RT @NSWRFS: 193 homes confirmed destroyed, 109 damaged in Springwood/Winmalee area. URL #NSWRFS #nswfires	Infrastructure and utilities
Blazing fires, Hazardous air: I live in the Northern Beaches of Sydney, about 1 hour East of the Blue Mountain... URL	Affected individuals
Take care with all this Bushfire smoke around: some helpful tips from Asthma Australia Foundation. #ausunions #fires URL	Sympathy and support
RT @AnthonyClarkAU: Incredibly proud of the #NSWRFS public info team over the last few days. In the age of technology and immediate info, t‚Ä¶	Other Useful Information
RT @gerfingerpoken: @lonelycon 98 (IBD) Al Gore Throws Another Climate Lie On The Barbie - Blames Australia Fires On Climate Change URL	Other Useful Information
RT @MarshallThomasB: Abbott using the NSW bush fires for a photo opportunity URL	Other Useful Information
RT @NationalPrayer: PRAYER ALERT: Remain in prayer for those fighting the #WaldoCanyonFire in Colorado Springs &amp; the 32,000+ people  ...	Sympathy and support
RT @AshleyLeahy: Abbott Government cruelly refuses compensation to NSW fire victims. Action speak louder than propaganda URL	Other Useful Information
RT @instagram: Frightening photo of the Colorado #wildfire by @dredayy66: URL Please stay safe!	Other Useful Information
RT @AndoJC: @KasiaCichonska @Lee_Tennant @broomstick33 Torrential rain last night in Gippsland, fires in NSW, drought in Qld &amp; the Libs thi‚Ä¶	Affected individuals
What a week it's been!  #highparkfire you better behave today.  URL	Sympathy and support
Army criticised over Australia fire: Australia's military faces criticism after it is blamed for starting one ... URL	Other Useful Information
RT @ABCNews24: Shane Fitzsimmons: There are more than 60 fires across NSW, 15 of those remain uncontained #nswfires #bushfires	Caution and advice
Furious Wildfire in Colorado Leaves Destruction in Its Wake URL	Other Useful Information
The fire in Colorado is still burning?	Other Useful Information
thoughts and hugs to @Susan4Macquarie who lost her family home as well. #nswbushfires	Sympathy and support
RT @ABCNews24: #BREAKING: Emergency warning for bushfire at Browns Rd, Port Stephens NSW. Fire info at URL or @NSWRFS	Caution and advice
RT @seanhfitz: So, the fires in Colorado are God's wrath for what this time?	Other Useful Information
RT @KLOVERadio: Please RT if you will join us in praying for those impacted by the fires in Colorado &amp; those fighting the fires. htt ...	Sympathy and support
RT @NSWRFS: If you find an injured native animal, call WIRES 13000WIRES or DPI for livestock.  URL @WIRES_NSW #nswfires	Not applicable
RT @justinbarbour: RT @PMOnAir: Adam Bandt is a disgrace. I can't think for a more inappropriate tweet. #nswfires #sydfires #pmlive  URL	Other Useful Information
Federal firefighters go uninsured: As brutal wildfires spread in Colorado, federal fighters, along with state an... URL	Other Useful Information
RT @DanMacPherson: Just up to speed on today's horrific fires. Thoughts with all involved. Heartbreaking. Just heartbreaking.  #nswfires	Sympathy and support
my prayers go out to the families effected by the Colorado fire. #besafe &lt;3	Sympathy and support
RT @PadsCast: The fires are in Colorado Springs but there is a haze in the sky in Denver and you can smell the smoke because of the high ...	Other Useful Information
RT @BBCWorld: Australia bush fires set to worsen URL	Other Useful Information
RT @snowflakeharry: i'm suprised the boys are allowed to go to sydney bc of the bush fires to be quite honest	Other Useful Information
RT @BBCInPictures: BBC - In pictures: Australia fires blaze: URL via @youtube #BBC #InPictures #Australia #Wildfire #Bus‚Ä¶	Other Useful Information
Jesus...half this state is on fire and its 102¬∞ right now.  #summerfun colorado style	Other Useful Information
People in Colorado shrug off a gigantic fire that one one can put out due to the unstoppable wind, but they have a heart attack over rain...	Other Useful Information
RT @Coloradoan_TH: Photos from one of the wildland firefighters working here: RT @BrittIronShell: When we had night shift #HighParkFire  ...	Affected individuals
RT @newscomauHQ: Investigations by NSW RFS fire investigators have determined the State Mine Fire... was started as a result of live ordna‚Ä¶	Other Useful Information
We send this prayer to all those affected by the #Colorado fires.  URL	Sympathy and support
RT @smh: New emergency warning issued. Burning embers being blown towards Wilton, @NSWRFS says: URL #nswfires	Caution and advice
Baptism of Fire: @coopesdetat gets a little too close for comfort while covering Australia's wildfires URL  #nswfires	Other Useful Information
NSW ** Watch and Act - Webbs Creek (Hawkesbury) ** 13/10/13 15:57   A bush fire is currently burning between... URL	Infrastructure and utilities
'We have the ability to name and shame' @BarryOFarrell says of people trying to take financial advantage of #nswfires URL	Not applicable
DEVASTATING FIRES IN NSW...PLEASE LOOK OUT FOR INJURED WILDLIFE.   Bushfires and wildlife URL	Caution and advice
Thoughts and prayers with everyone who has been affected by the fires and hope they can stay strong in the upcoming days #nswfires	Sympathy and support
RT @NSWRFS: If you find an injured native animal, call WIRES 13000WIRES or DPI for livestock.  URL @WIRES_NSW #nswfires	Other Useful Information
RT @LC2020: If you live near a bush fire zone please put out a bucket of water for wildlife. Please retweet #nswfires #wildlife URL	Other Useful Information
Denver Post Should Receive Pulitizer Prize for its Coverage of Colorado Fires:  URL	Other Useful Information
RT @Sarakateee: RIP Colorado. Cause of death: fire.	Sympathy and support
Vandenberg sends Hot Shots to Colorado wildfire front lines URL	Other Useful Information
RT @LMBeautyShines: Colorado Springs is FINALLY trending.  This fire is the #1 priority in the US!!! :( Please pray for our community!	Sympathy and support
Unprecedented Colorado Wildfires Continue, As Strong Winds and Looting Add to the Problem URL	Other Useful Information
RT @mashable: Mashable's @zoebfox takes a look at how social media is helping Colorado wildfire relief URL	Other Useful Information
Colorado wildfire hops road: Firefighters Thursday made progress against a massive wildfire 15 miles west of For... URL	Other Useful Information
Best wishes for tomorrow everyone. Pls stay safe. #nswfires	Sympathy and support
The geoblock has been lifted for continuing coverage of #nswfires. International viewers can watch online here URL	Other Useful Information
Massive Australia bush fire 'started by Defence Department' via @Telegraph URL	Other Useful Information
RT @CNN: Nearly 350 homes destroyed in Colorado Springs, officials say: URL	Infrastructure and utilities
Colorado wildfire smoke blows into Cheyenne, Wyo. - USA TODAY: USA TODAYColorado wildfire smoke blows into Cheyenne, Wyo.USA TODAYLOV...	Other Useful Information
Sydney skyline from the fires. #nswfires #fires #nswrrfs #Sydneyfires #bushfires #Sydney URL	Infrastructure and utilities
How Social Media Is Helping Colorado Wildfire Relief: More About: disaster relief, red cross, Social Media URL	Donations and volunteering
RT @wilw: RT @SidSuicide Can you please RT? Visit URL  to help with the Colorado fires. #WaldoCanyonFire Help if you  ...	Donations and volunteering
Australian PM @TonyAbbottMHR must be glad that climate change is crap &amp; the 3-month's early #nswfires are just part of the natural cycle.	Other Useful Information
RT @Channel9: #NSWFires UPDATE: 58 fires are still burning with 14 uncontained! For emergency information on the fires call 1800 679 737 #9‚Ä¶	Caution and advice
RT @thetodayshow: FIRE UPDATE: Fire behaviour will intensify soon. Important to remain vigilant and move to safe places. #nswfires #today9	Caution and advice
Have you been keeping up with the Australia NSW fires? Keep them in your thoughts and prayers. URL	Sympathy and support
15 Australia wildfires still burning out of control: Authorities warn high temps, strong winds likely to keep heightened fire danger ...	Caution and advice
Colorado wildfire: Winds at Waldo Canyon Fire concern officials - San Jose Mercury News URL	Other Useful Information
Sky News - Colorado Wildfires: Blaze Claims First Life URL	Affected individuals
RT @RedCrossAU: .@Optus customer? Text DONATE to 19 Relief. 100% of funds will go to our work with #NSWbushfires &amp; other disasters.	Donations and volunteering
So sad! 43,000 acres, 5% contained, 500 firefighters...100 homes destroyed, 1 dead. #wildfire #HighParkFire URL	Infrastructure and utilities
Colorado Fire Relief benefit concerts at Red Rocks to help wildfire victims  Auctions start NOW 7 a.m. - 10 a.m. URL	Donations and volunteering
@gearfisher Sorry to hear of your loss Gear.  All the best to you and the rest of the CO residents in these tough times #highparkfire	Sympathy and support
We will try and keep our page up to date with fire updates around NSW as they come to hand	Caution and advice
RT @KimberleyL: :) RT @alexlee_24: @KimberleyL Two fires at Sydney Water and Sydney Aquatic Centre within a week. When did fire develop a s‚Ä¶	Not applicable
RT @nprnews: Good News: 'Great Progress' Reported In Fighting Colorado Springs Fire URL	Other Useful Information
RT @purplelandia310: Fighting NSW Fires with Twitter by @Michae1Green via @KINSHIPd URL	Caution and advice
RT @cnnbrk: Colorado #wildfire doubles in size on Sunday. URL	Other Useful Information
RT @SpeakerBoehner: Thoughts &amp; prayers are with the victims of the Colorado wildfires, &amp; with the brave fire crews working day & ...	Sympathy and support
RT @mattdoran22: Reports a chopper has crashed fighting fires near Ulladulla #nswfires #eyewitnessnews @channeltennews	Affected individuals
RT @LarimerHumane: Marsha and her husband had to leave their horses and evacuate immediately from the #HighParkFire. Larimer Humane... h ...	Affected individuals
RT @nswia_weather: There are now over 100 fires burning throughout NSW, over 40 remain out of control.	Infrastructure and utilities
RT @abcnews: The Hawkesbury Showground has become a makeshift animal sanctuary due to the bushfire threat. URL #nswfires	Infrastructure and utilities
RT @OneRepublic: Colorado Springs wildfire.  God preserve us URL	Sympathy and support
@chipmaclasco you're a better man than me. I hope Tim Thomas loses everything in the Colorado wild fires #ShouldveStayedInBoston	Other Useful Information
We've reached the point of our trip to Colorado that we should be able to see mountains but because of the wildfires all we see is a haze.	Affected individuals
How to assist Colorado wildfire victims, how to donate and help - The Denver Post URL	Donations and volunteering
RT @coloradodaily: Latest on the #FlagstaffFire w/photo, video &amp; map: URL	Other Useful Information
RT @nswpolice: Fires, floods and park closures: See latest updates and alerts for national parks across NSW - URL	Infrastructure and utilities
9 Shocking Twitter Pictures From the Colorado Springs Wildfire URL	Other Useful Information
Is it counter-productive to link NSW bush fires with climate change when the majority are caused by humans? #ClimateChange	Other Useful Information
RT @denverpost: ALERT: How to assist Colorado #wildfire victims, how to donate and how to help: URL #cofire	Donations and volunteering
Weather fear as Australia fires burn URL	Caution and advice
I have it on good authority that most of Colorado‚Äôs Front Range is on fire. Many displaced families, little relief in sight. So sad to hear.	Affected individuals
RT @freddoso: A lot has happened since Obama last called Colorado's governor about the fires. 18 Obama fundraisers, for example URL ...	Other Useful Information
Australia Fires: Man Dies As Homes Destroyed URL	Affected individuals
RT @AC360: A team in #Colorado uses technology to predict movement of wildfires by studying weather. Details on AC360 now.	Other Useful Information
RT @ColoradoStateU: Meet Ellie, a donkey who lead another donkey and 4 horses to safety before evacuation from #HighParkFire. URL ...	Other Useful Information
RT @ClimateCentral: The largest fires in Australia in a decade have turned Sydney's skies orange: URL	Other Useful Information
„ÄêNews„Äë Colorado wildfires: President Obama declares disaster - BBC News URL	Other Useful Information
RT @ShannonCarr_10: ‚Äú@LittleM_BigA: Fire at minmi from edgeworth @1233newcastle #nswfires URL	Infrastructure and utilities
RT @MeetAnimals: A dog has risked its life to save a litter of newborn kittens from a house fire in Melbourne, Australia. URL	Other Useful Information
RT @fadichahine: Every life is precious #nswfires URL	Other Useful Information
1 dead as Colorado fire destroys over 300 homes- uReport: Colorado wildfire URL #IHateTimWaterman	Affected individuals
These colorado wildfires are no joke	Sympathy and support
Blaze hits Australia Olympic park: A fire in Australia's Olympic park destroyed or damaged around 80 cars and ... URL	Infrastructure and utilities
RT @NSWRFS: Information on employment protections for NSW RFS members involved in the current fires URL #nswfires #NSWRFS	Affected individuals
#nswpol #auspol #BlueMountains #Blackheath #MtVictoria #nswfires Heroes =@NSWRFS @FireRescueNSW  Pg2  newsletter URL	Other Useful Information
RT @7NewsSydney: CHOPPERCAM: Emergency warning issued for area of Stockrington Road, west of the M1, heading towards Minmi #NSWfires URL	Caution and advice
RT @RebelWilson: Thinking of everyone in Western Sydney who are being affected by the bush fires x be safe x	Sympathy and support
#HighParkFire UPDATE: Re-Evacuations being announced for Hwy 14, east of Seaman Reservoir.	Caution and advice
Obama to visit Colo. to review fire damage: President Obama will fly to Colorado Springs on Friday to review the... URL	Other Useful Information
@BasedBieberLife In pictures: Australia fires blaze: Almost 60 wildfires in New South Wales  @deadmau5	Other Useful Information
Colorado Springs fire threatens the Air Force Academy #WaldoCanyonFire #COFIre URL	Infrastructure and utilities
RT @fema: (June 27) Please share: how to help those affected by the #WaldoCanyonFire #FlagstaffFire #HighParkFire URL	Donations and volunteering
President Obama to tour #WaldoCanyonfire Friday URL via @denverpost #cofire #potus	Other Useful Information
Where the fuck is @TonyAbbottMHR &amp; @GregHuntMP today to stand among these burnt homes &amp; spout climate denial bullshit. #nswfires	Other Useful Information
F√• nyt om brandv√¶senets kamp mod skovbrandene i Australien ved at f√∏lge @NSWRFS p√• Twitter. Se ogs√• hashtags: #nswfires &amp; #nswrfs	Not applicable
Thank you to our brave firefighters. You personify the resilient Australian spirit. We love you. We thank you. We praise you. #nswfires	Sympathy and support
RT @AP: Wildfire near Colorado Springs quickly becoming dangerous threat as thousands of residents evacuate homes: URL -JM	Affected individuals
Australia fire investigators say military exercise may be cause of wildf...: URL via @youtube	Other Useful Information
RT @Aportzline: #CBJ fans should know @kschroeder1720 - portly, shirtless dancin' guy in Nationwide - is near Colorado fire evacuation z ...	Other Useful Information
US: All three network evening newscasts leading tonight with the rampage of that #wildfire in #Colorado	Other Useful Information
RT @ryanmunyan: ‚Äú@bretstrelow: Colorado Springs fire approaching Air Force football stadium. This pic, just wow URL un ...	Caution and advice
RT @egorski: Bizarre to hear a Colorado Springs TV reporter interviewed on the BBC tonight #WaldoCanyonFire	Other Useful Information
(Video) 'We're planning for the worst but hoping for the best' ~ Australia declares fire emergency URL	Caution and advice
@28CGiroux please pray for Colorado Springs, Colorado. There is a giant wild fire burning the town. Please RT to raise awareness.	Sympathy and support
Colorado's banned fireworks due to all the fires. üòû Save me some, Virginia.	Other Useful Information
RT @TripleMSydney: Pull back, pull back, pull back. Say Again over... The chilling footage from the #nswfires frontline @NSWRFS URL	Other Useful Information
URL #boulderfire	Other Useful Information
RT @AJELive: #Australia weather increases threat of fires URL	Other Useful Information
Australian military probes fire link: Australia's military is investigating whether a training exercise using ... URL	Other Useful Information
It‚Äôs 5¬∞ here, near Melbourne. If Australia is doing this on purpose, someone make it stop.  RT @lukedez: Australia does like to catch fire.	Sympathy and support
This is just horrible #nswfires URL	Other Useful Information
RT @5SOSDailyNews: Praying for everyone in Western Sydney that is being affected by the bush fires, please stay safe x	Sympathy and support
Military live ordinance exercises was cause of one of the fires raging in #Australia URL v @jaraparilla	Other Useful Information
Im praying for my homie up in Colorado, Springs.. Hella wildfires up there.	Sympathy and support
@Reuters bush fires in Australia have been happening for over 200 years. Is excessive snow in the UK also caused by #ClimateChange?	Other Useful Information
They need us as well #nswfires URL	Donations and volunteering
terrible forest fires in colorado springs. lived there for a couple of months in the 90s. beautiful hills URL	Affected individuals
Hoping the rain is falling in the right places #nswfires	Sympathy and support
From #Cranebrook looking at #Winmalee #bluemountainsfires #nswfires @Channel7 @thetodayshow URL	Other Useful Information
Photo: Live shot from the ABC helicopter of smoke over the #BlueMountains from the #MountVictoria fire #nswfires URL	Infrastructure and utilities
Fires could head toward Sydney URL #news	Caution and advice
Colorado Fires... Flying W - URL URL #FLYINGWRANCH #COLORADOFIRES	Other Useful Information
RT @treisiroon: Military live ordinance exercises was cause of one of the fires raging in #Australia URL v @jaraparilla	Other Useful Information
RT @themishawaka: As per this morning's burn maps, we've still managed to remain away from the fire. #HighParkFire #grateful	Other Useful Information
Most destructive ever Colorado wildfire burns 181 homes - U.S. News URL #COLORADOWILDFIRES	Infrastructure and utilities
Praying hard. RT@DenverWestword: High Park fire update: 83K-plus acres, 248 homes confirmed destroyed  #highparkfire URL	Infrastructure and utilities
Colorado to double wildfire crews URL	Other Useful Information
RT @FeedingAmerica: The outpouring of support for @careandsharefb is awesome! They are helping the Colorado fire evacuees URL ...	Donations and volunteering
News by BBC Australia bush fires set to worsen: Australian firefighters warn that the return of hot weather an...  URL	Caution and advice
RT @workmanalice: Amazing photo from a friend in Katoomba on the road to Blackheath. #nswfires URL	Other Useful Information
#WaldoFire Pre evacuation area has been expanded for the Woodland Park area  per text from #TCSO	Caution and advice
Our best wishes go out to all those affected by the NSW bush fires. If you're  in AUS and would like to donate you can do - dial 1800811700.	Sympathy and support
RT @AC360: Firefighters are up against dangerous conditions trying to control the #Colorado wildfire. The latest from @chadmyerscnn 8 &a ...	Other Useful Information
RT @denverpost: PHOTOS: Here's an updated look at the #HighParkFire through the lens of @denverphotos: URL	Other Useful Information
RT @workmanalice: Amazing photo from a friend in Katoomba on the road to Blackheath. #nswfires URL	Affected individuals
RT @StyleEngine: Colorado Springs is burning, this gives you an idea of how bad the wild fire is... URL	Other Useful Information
RT @TheEllenShow: Australia's 1 of the most beautiful places I've ever been to. Images of the fires are heartbreaking. Sending all my love ‚Ä¶	Sympathy and support
RT @nourbaby: Those Colorado wildfires look scary. Prayers to everyone near there	Sympathy and support
Great one here: Colorado wildfire roars to 73 square miles - Fox News  [a link in my bio]	Other Useful Information
RT @geehall1: RT @Prussan: Charred material found at UNSW. #nswfires URL	Other Useful Information
Firefighters search door-to-door for bodies in Colorado wildfire - Fox News: ABC NewsFirefighters search door-to... URL	Affected individuals
Governor General Quentin Bryce has visited the Blue Mtns today, thanking firefighters #NSWRFS #nswfires URL	Sympathy and support
#HighParkFire info on #LarimerCounty webpage. A lot of advice about prepping for a fire, safety lists, evacuation checklists, structure maps	Caution and advice
RT @LauraTunstall9: Exhausted firefighters have worked through the night here in Winmalee ahead of horror weather conditions #nswfires URL	Affected individuals
RT @bazarazzi: Government cut in aid 'heartless'. Appalling. Shame on you @MichaelKeenanMP. URL #nswfires	Sympathy and support
RT @MarkDiStef: Smoke billowing from the car-park at Sydney Olympic Park... where 20 cars are on fire via @Quarriephoto URL	Infrastructure and utilities
RT @Buzzoot: In solidarity with our brothers and sisters in Colorado, let's hope and pray for a quick end to the fires #PrayForRainInCo  ...	Sympathy and support
RT @missnatalienunn: ‚Äú@DevTheBarbie: @missnatalienunn Pray for ur Rockstars in Colorado that are being affected by this horrific fire pl ...	Sympathy and support
RT @PolitixFireball: Please pray for those affected by the fires in Colorado! Here's @MichelleMalkin's update:URL #Brei ...	Sympathy and support
#Gov20 News - Forest Service calls in Air Force tankers to battle Colorado fires URL	Other Useful Information
#nswfires A picture tells 1000 words  Photos from #firefront a&amp;/or smoke plumes help @nswrsf fight #nswfire Email to: photos@rfs.nsw.gov.au	Other Useful Information
RT @NSWRFS: Likely to be heavy smoke across Sydney and much of the state Dont call 000 just for smoke only for unattended fires   URL	Caution and advice
Hope all these fires in Colorado end soon!	Sympathy and support
RT @AP: AP VIDEO: Wildfire tearing through northern Colorado destroys the house that Jeff Corum recently renovated: URL ...	Infrastructure and utilities
@Kajahh @cmpunk but I think they said they were going to have double raw and SD since SD was canceled in Colorado because of recent fires.	Other Useful Information
RT @CNN: Nearly 350 homes destroyed in Colorado Springs, officials say: URL	Infrastructure and utilities
RT @accruick: we are available to house a displaced kitty or two if needed #flagstafffire cc @HumaneBoulder	Donations and volunteering
RT @reddit: Colorado Springs, CO is on fire.  65mph winds blew it into the city today.  Looked like Armageddon. URL [pics]	Other Useful Information
I uploaded a @YouTube video URL Waldo Canyon Fire - Colorado Springs, 9pm, June 25th	Other Useful Information
RT @TheSwearyNews: Australia's on fucking fire again. Firefighters have blamed Harold Bishop for smoking in bed again.	Other Useful Information
RT @pelagicpictures: Two rings of fire burn at dusk west of the Darling Causeway near Hartley Vale. @photosSMH #nswfires @NSWRFS @nswfire h‚Ä¶	Other Useful Information
RT @AP: AP VIDEO: Colorado wildfires double in size overnight, 'not remotely close to being contained': URL -EF	Other Useful Information
Hundreds evacuated as Colorado, New Mexico fires spread URL	Affected individuals
Colorado wildfires: Several fires explode across Front Range URL	Other Useful Information
RT @ABCNews24: #BREAKING: NSW RFS has confirmed an aircraft has crashed and rescue helicopters are responding #nswfires #bushfires	Affected individuals
‚ÄúIt‚Äôs ugly,‚Äù he said.  #HighParkFire #WaldoCanyonFire #COfire URL	Other Useful Information
RT @MelindaHealy: Newcastle airport closed due to smoke from bushfire at williamtown #fires #nsw #newcastleairport URL	Infrastructure and utilities
If you knew all that I knew, my poor Sydney...Have come home to raging fires. Prayers please. :(	Sympathy and support
RT @climatehawk1: Climate Code Red: Is Abbott govt fiddling while NSW burns?: URL #climate #globalwarming #fire #divest	Other Useful Information
Lololol according to NBC all of Australia is on fire... Ummm where do they get their sources from?? #nbc #bushfires	Other Useful Information
Fire brings Colorado Springs evacuations  URL	Affected individuals
RT @theinquisitr: Colorado Wildfires Coming Under Control After 'Unreal' Devastation - URL	Other Useful Information
@AndrewCatsaras just read big fire for Sydney? hope not really serious?	Other Useful Information
RT @EdJReporter: Fears #nswfires could join up and form a mega-blaze. Via @nswfire: @DeptDefence closely monitoring #nswfires crisis URL	Other Useful Information
RT @R5_Fire_News: Ready, Set, Go! for #wildfire evacuations in #CA  URL  URL	Other Useful Information
Colorado wild fire now 44,000 acres and growing - respect for the fire fighters, thoughts with the homeless	Affected individuals
RT @cnnbrk: #Colorado firefighters facing more wind, heat. URL	Affected individuals
RT @kariontour: Prayers going out too all the people in Colorado and the other states dealing with these deadly fires.	Sympathy and support
Plane fighting Australia fires crashes as cooler weather eases threat: SYDNEY (Reuters) ‚Äì A plane dousing wild... URL	Affected individuals
Just found out one of my friends in Colorado might have lost her apartment to the fires there. Will know more tomorrow. That sucks :(	Affected individuals
Please keep the Colorado Fire in your prayers! It's crazy up there	Sympathy and support
NSW Fire Update:  Significant damage: Lithgow, Yanderra, Balmoral &amp; Central Coast.  Emergency Warning: Heathbrae area.  Hundreds homes lost.	Infrastructure and utilities
RT @gbrockell: Wow this is the most amazing map of the #highparkfire I have seen. Takes a while to load but worth it. URL	Other Useful Information
RT @NSWRFS: A busy day with great work by #nswrfs, @FireRescueNSW, Nat Parks, Forests, @nswpolice and the community. Thank you. #nswfires	Sympathy and support
Thoughts going out to everyone affected by #nswfires	Sympathy and support
RT @K_Wills21: So I set the world on fire!  (whoops, sorry about that, Colorado)	Other Useful Information
RT @NSWRFS: #Lithgow Fire: Major Fire Update URL Fire is impacting Morts Estate, Clarence and Dargan. #NSWRFS #nswfires	Other Useful Information
RT @Lisa_Wilkinson: To all the men &amp; women out there today fighting the good fight in the worsening #nswbushfires thank you. Your bravery &amp;‚Ä¶	Sympathy and support
RT @DearNinax3: Crazy fires in Colorado üóªüî• URL	Other Useful Information
Sitting here inhaling the #nswbushfires smoke. Can't imagine what ppl are going through. Buy an ad this week &amp; we'll donate to the victims.	Donations and volunteering
RT @astropixie: wow!  this isnt rain on the radar, its a huge smoke plume covering sydney from fires in lithgow! URL	Infrastructure and utilities
RT @SteveSchmuhl: 32,000+ people evacuated in Colorado Springs #cofires	Affected individuals
Prayers for the safety and well being of all as wildfires close in on Colorado Springs.	Sympathy and support
RT @ABCNews24: #nswfires LIVE: NSW Rural Fire Service providing an update on  the #bushfires. Watch URL URL	Caution and advice
Wow!  The @9NEWS live stream does NOT look good of the #FlagstaffFire in Boulder right now.  #fb	Other Useful Information
...keeping a wary eye on the #SpringerFire. Sure, it's a way from us now, but so was Hayman before it blew up.	Other Useful Information
My thoughts &amp; prayers go out to the victims and lost of loved ones to the wildfires in colorado. i wanna do a fundraiser.	Sympathy and support
On-air shortly with Early Edition on @NewstalkZB - talking TeamNZ with Peter Lester, NSW bush fires plus Bill English is on the programme.	Other Useful Information
amazing. summer hasnt even started in australia, and it's already forest fires.	Sympathy and support
RT @DrOz: My prayers go out to everyone in the Colorado Springs area. Stay safe!	Sympathy and support
RT @TheEllenShow: Australia's 1 of the most beautiful places I've ever been to. Images of the fires are heartbreaking. Sending all my love ‚Ä¶	Sympathy and support
RT @HuffingtonPost: New 200-300 acre fire burning in Boulder, Colo. prompts evacuations #FlagstaffFire URL	Caution and advice
Watching URL video: Climate change partly to blame for Colorado wildfires -   URL via @msnbc	Other Useful Information
More evacuated as wildfires spread in New Mexico, Colorado URL	Affected individuals
Ciggie butt may have started Sydney fire:      A cigarette butt is suspected of causing a grass fire at Sydney... URL	Other Useful Information
Thousands Evacuated as Colorado Wildfires Close in on Tourist Destinations  URL	Other Useful Information
Say cheese! Hope you are all having a great Friday. Our thoughts go out to those in the NSW bush fires. URL	Sympathy and support
Australia NSW Bushfires 56 Fires Scorch Eastern Australia; State Of Emergency Declared: URL via @YouTube	Caution and advice
RT @PatrickSandusky: This is colorado springs right now. Look at this photo and be shocked.  Its f'ing armageddon here URL	Other Useful Information
Hey fam. Please pray for the residents of Colorado. With the winds, the fires are spreading rapidly. We are praying for you, Colorado!!!!	Sympathy and support
RT @TmCentralCoast: ‚Äú@NSWRFS: Important information about donations URL  #nswfires‚Äù	Donations and volunteering
RT @702sydney: A couple of kilometres of ember activity being reported at #wilton : @NSWRFS #nswfires	Other Useful Information
'Unparalleled danger' from Australian bushfires: Sydney (AFP) - Australian fire crews stepped up containment e... URL	Other Useful Information
Just got out work in the heart of Sydney CBD and the smell of smoke is strong. Eerie sky. Fire must be huge.	Affected individuals
Spreading the fire to 100 houses ashes Australia URL via @allvoices	Infrastructure and utilities
RT @Nneeiilliioo: All of Colorado is on fire... Except for the Rockies. #lastplace	Other Useful Information
Aftermath of a Forest Fire URL via @wordpressdotcom -- 16 #photos #wildfire #environment	Other Useful Information
@hash5wag: so sad #damn URL Colorado skies: wildfire style.	Sympathy and support
RT @DeltaGoodrem: Heartbreaking waking up to hearing about these bush fires in #NSW be safe everyone, in my prayers üôè üíú xx	Sympathy and support
@justinbieber  please bless my home Colorado springs is on fire :(	Sympathy and support
#nswfires Nov01 16:00 70km ESE of Walcha /Oxley Hwy Kangaroo Flat Rd &amp; Racecourse Trail #outofcontrol #bushfire 150ha URL	Caution and advice
Follow the #nswfires coverage with our live blog @smh URL	Other Useful Information
RT @CBSDenver #HighParkFire continues to have multiple heads, or fronts firefighters are working. Some homes found not burned in fire area	Donations and volunteering
RT @ABCemergency: #nswfires: 2 x Emergency Warnings in place for fires near #Lithgow #Bilpin + Mount York Rd fire near #MountVictoria URL	Caution and advice
#nswfires ALERT  Damaging winds around 60km/h with peak gusts of 90km/h forecast for #sydney Illawarra, Southern Tablelands, Snowy Mountains	Other Useful Information
RT @MGHReeves: #NSWRFS crews working in hot, smokey and difficult conditions at Bilpin. Pic from #Inglesiderfs URL	Other Useful Information
RT @Misschicka114: HELP ARRIVES!! A convoy of around 40 fire trucks from South Australia spotted coming up the Hume Highway URL	Other Useful Information
RT @RVRB: #WaldoCanyonFire benefit concert to feature the Fray‚Äôs Isaac Slade with the Colorado Springs Philharmonic: URL	Donations and volunteering
#LarimerCounty Colorado, #HighParkFire Map of fire: URL	Other Useful Information
Watching @SkyNewsAust The fires in Sydney are horrendous. Thoughts out to all the residents and wildlife affected by this tragedy.	Sympathy and support
For all in Sydney and most of Illawarra ‚Äú@Nyx2701: Sydney Water statement: #BlueMountains #bushfires URL #NSWFires‚Äù	Caution and advice
Be safe my south boulder friends. This one breaks my heart :( #flagstafffire #tooclosetohome URL	Sympathy and support
RT @julieposetti: 95 fires burning in NSW, 34 out of control. Sen D Cameron: If I hear anyone in parliament say there's no climate change,‚Ä¶	Other Useful Information
RT @TheQTIC: QTIC's thoughts are with those families and businesses affected by #NSWfires. Financial donations go to the @salvos URL	Sympathy and support
RT @LarimerSheriff: #HighParkFire update URL	Other Useful Information
RT @abcnews: Tony #Abbott: We are not called a land of droughts and flooding rain, a sun burnt country for nothing #NSWfires	Other Useful Information
Ash cloud covers Sydney as fires rage: Five major bush fires have threatened hundreds of homes in New South Wales¬†¬†¬†¬†	Infrastructure and utilities
RT @adambombshow: to all our Colorado Springs listeners, we're praying for you. crazy fires URL	Sympathy and support
scammers going door-to-door in Co Springs claiming to take donations for #WaldoCanyonFire victims #Colorado /cc @CSPDPIO via @ryanprast	Caution and advice
RT @HuffingtonPost: Photo gallery of the multiple devastating wildfires burning across Colorado URL	Other Useful Information
RT @brookejarvis: Colorado's on fire. Livestream of the fire prompting evacuation warnings in Boulder: URL #flagstafffi ...	Caution and advice
#IFWT Colorado Wildfires Getting Worse - URL	Other Useful Information
RT @702sydney: Incredible photo of @NSWRFS firefighter engulfed in flame and crawling out of the fire.He is OK #nswfires URL	Other Useful Information
@thetodayshow   People are still throwing cigarette buts out of car windows, it is truly disgusting.  #nswfires	Other Useful Information
RT @smh: High fire alert tomorrow, hitting temps of 34 in #Sydney with strong winds, creating severe fire danger. URL	Caution and advice
#teamfollowback Australia bush fires set to worsen URL  #autofollow	Other Useful Information
RT @david_latham: With bush fire smoke descending on Sydney Miranda voters should remember Ofarrell has closed fire stations and cut fire s‚Ä¶	Infrastructure and utilities
RT @thetodayshow: UPDATE: 83 fires burning, 19 uncontained. 81 homes destroyed, 37 damaged across NSW. @deborah_knight #today9	Infrastructure and utilities
Emergency Warning - Hank St Fire (Heatherbrae) URL #NSWRFS #nswfires	Caution and advice
RT @bouldercounty: Material donations are NOT needed for the #FlagstaffFire at this time. Financial support is the best way to help. Inf ...	Donations and volunteering
RT @bouldercounty: As a reminder, the call center for residents and others impacted by the #FlagstaffFire to obtain information is 303-4 ...	Other Useful Information
RT @Neinusername: Prime Minister Tony Abbott joins Davidson Rural Fire Brigade to fight NSW bushfires URL #auspol	Other Useful Information
RT @louanndonovan: Photo taken by someone of wildfire in Colorado Springs. Shows #SalvationArmy there helping. #waldocanyonfire URL ...	Donations and volunteering
RT @stormchaser4850: Developing: Around 32,000 evacuated in the Colorado Springs, CO area due to destructive wildfire via press conference	Affected individuals
RT @ronanofficial: Our thoughts and prayers are with everyone caught or involved in the #nswfires.	Sympathy and support
RT @BathSaltsJesus: A RARE PiCTURE OF A FiREFiGHTER GiViNG DiRTY SPRiTE TO A YOUNG KOALA BEAR DURiNG BUSH FiRES iN AUSTRALiA URL	Other Useful Information
RT @LarimerSheriff: #HighParkFire New acreage for High Park Fire is 65,738 with 55% containment.  Here is link for updated map URL ...	Other Useful Information
RT @TCorbett2908: ‚Äú@SBSNews: Comment: Is it right for @AdamBandt and others to link #nswfires with climate change policy? URL	Other Useful Information
More homes threatened in Australia fires URL	Infrastructure and utilities
RT @SA_MFS: A sea of  @CFSAlerts @SA_MFS &amp; @SA_SES personnel were briefed @AdelaideAirport before heading to #NSWfires this arvo. URL	Caution and advice
RT @LarimerCounty #HighParkFire website containing fire info, maps, Disaster Recovery Center details URL #cofire #smem	Donations and volunteering
Lord please bring rain upon Colorado üí¶üí¶ so these fire would stop and folks would stop losing there homes! Everyone please pray for Denver	Sympathy and support
Amazing skies in Sydney at the moment with bush-fires nearby. URL	Other Useful Information
RT @BBCWorld: We're planning for the worst but hoping for the best - New South Wales Premier Barry O'Farrell on Australia fires URL	Other Useful Information
BBC News - Hundreds forced from their homes by Colorado wildfire URL	Affected individuals
RT @workmanalice: Amazing photo from a friend in Katoomba on the road to Blackheath. #nswfires URL	Other Useful Information
‚ÄúLatest info: 36,930 acres, 18 structures damaged, 1 person missing. All stories and updates here: URL #HighParkFire‚Äù	Infrastructure and utilities
positive thoughts to the people in waldo canyon~colorado springs~surrounding areas..hope those winds subside so they can control those fires	Sympathy and support
Please join us in praying for the fire fighters who are bravely combating the bushfires across NSW. Our prayers... URL	Sympathy and support
RT @thetodayshow: UPDATE: 64 fires burning, 24 uncontained. Dropped temperatures but strong winds. Authorities warn: #nswfires crisis is fa‚Ä¶	Caution and advice
Please continue to pray for Rachel &amp; Jesse and all of those in the Colorado fire. URL	Sympathy and support
#WaldoCanyonFire: No new evacuations for Colorado Springs &amp; no changes to previous mandatory evacuations. Streaming: URL	Caution and advice
RT @tmrounsaville: View of #highparkfire from #hughesstadium #csu the smoke was unreal on Sunday @coloradostateu URL	Other Useful Information
#HighParkFire has burned about 73 square miles. Washington, DC measures 68 square miles. NASA photo t.co	Infrastructure and utilities
RT @DeniseOConner: Will the great libertarian experiment of Colorado Springs will just put out the fires by throwing copies of _Atlas_...	Other Useful Information
Praying for Sydney, Australia concerning the bush fire situation. URL	Sympathy and support
RT @felicityward: Sydney skyline #Sydney #bushfire #reflectionsofglass URL	Other Useful Information
High Park Fire in Colorado URL	Other Useful Information
RT @thetodayshow: Here's a NASA satellite photo showing the #nswfires #today9 URL	Other Useful Information
Hanhnenberg: Currently we have the resources we need and will continue to but there will be competition for resources. #HighParkFire	Other Useful Information
RT @9NewsNOW: The latest details on the #nswfires, including the RFS aircraft that crashed on the NSW south coast. @samvadas9 reports in #9‚Ä¶	Other Useful Information
Flick on TEN now RT @DaniIsdale: @SouthwoodEllie coming back live with update before the end of the show @TenLateNews #SydneyFires	Not applicable
Colorado wildfire forces 11,000 people to leave their homes \\ Guardian \\ URL	Affected individuals
FEMA has authorized the use of federal funds to help with firefighting costs for the #HighParkFire. URL	Other Useful Information
RT @BULMKT: There is no Climate Change link to the #nswbushfires but there is a direct link between #Ecotardism and Adam Bandt #auspol	Other Useful Information
RT @TheSwearyNews: Australia's on fucking fire again. Firefighters have blamed Harold Bishop for smoking in bed again.	Other Useful Information
RT @wadedh: RT @NationalPrayer: PRAYER ALERT: Remain in prayer for those fighting the fire in Colorado Springs &amp; 32,000+ people evac ...	Sympathy and support
RT @DenverChannel: @Bri_Smith91 Sadly rain, well the lightning that came with it, started the Boulder fire yesterday.	Other Useful Information
RT @SamEBJones: RT @MissBaileyWoof: Joey rescued after sustaining burns to his paws #nswfires URL	Other Useful Information
The Red Cross is sending one of its Texas leaders to Colorado. How they're helping in the midst of devastating wildfires on #KVUEMidday	Donations and volunteering
.@deadmau5 Weather fear as Australia fires burn: More than 3,000 firefighters in Australia battle devastating bushfi...  @BasedBieberLife	Affected individuals
I might be able to see the Colorado wildfires from my plane.. That would be sweet	Other Useful Information
RT @SMDayFoCo2012: Donationsl continue for #HighParkFire at Foothills Mall. #HelpColoradoNow. If you are out an about this morning,... h ...	Donations and volunteering
RT @9NewsSyd: UPDATE: Smoke from fire around #Dudley &amp; #Redhead could affect surrounding suburbs #nswfires URL	Caution and advice
These bush fires are scary :( stay safe everyone!! #Sydney #bushfires #hot	Sympathy and support
RT @WSJ: A Colorado fire forced 32,000 residents to evacuate. It doubled in size overnight to 24+ square miles. Photos: URL	Affected individuals
RT @woolkebb 1m  Stop Tony Abbott fanning the flames of climate change. Sign now #nswfires URL ‚Ä¶	Other Useful Information
I really hope that someone did not deliberately start any of the fires going on here in Colorado, that would be just disgusting. Absolutely.	Sympathy and support
Colorado State University classes disrupted by High Park Fire ‚Äì 9News URL	Other Useful Information
Helicopter collecting water for multiple cars on fire at Sydney Olympic ...: URL via @youtube @ChrisBath7	Infrastructure and utilities
The copter is on the way to the #HighParkFire. We'll be airing it live throughout our coverage. You can also follow @CodyCrouch for pics.	Other Useful Information
RT @MarkDiStef: Defence Dept's been investigating after revelations it started NSW's biggest fire. Ch7 says Defence now admitted to @NSWR‚Ä¶	Caution and advice
RT @WhitleyStrieber: In the next 24 hours, the Colorado fires either become a historic catastrophe or not. However you help others in yo ...	Sympathy and support
RT @diversionary: Whoa. RT @workmanalice: Amazing photo from a friend in Katoomba on the road to Blackheath. #nswfires URL	Infrastructure and utilities
RT @RobertOvadia: RIP chief pilot David Black from NSW Central West, killed fighting the #NSWFires this morning. A good man. URL	Affected individuals
RT @convectivetweet: Massive Wildfire near Colorado Springs. URL	Other Useful Information
Even as fires burn out of control around NSW - O'Farrell Govt accused of cutting #climate change research! via @ABC URL	Other Useful Information
Just when we thought it was safe to go outside. #CO #Wx  &gt;&gt; Fri=97 degrees Sat=100 degrees. You know what that means. #HighParkFire	Other Useful Information
A picture someone took of Colorado Springs looking downright apocalyptic   URL	Other Useful Information
@BasedBieberLife Australia bush fires set to worsen: Australian firefighters warn that the return of hot weather and strong...  @deadmau5	Caution and advice
Damage Assessment teams for #HighParkFire being assembled to determine what' structures have been burned, damaged or untouched.	Infrastructure and utilities
RT @michaelneale: The NSW fireys are doing an awesome job. If it was safe I would supply them with cold beer, but fires.	Sympathy and support
Colorado wildfire: High Park Fire near Fort Collins devours 37000 acres	Other Useful Information
RT @coloradodaily: Pretty amazing time-lapse video of the #FlagstaffFire here: URL	Other Useful Information
‚Äú@mashable: 9 Shocking Twitter Pictures From the Colorado Springs Wildfire URL awful -pray for those affected	Sympathy and support
Live feed for #WaldonCanyonFire #Wildfire #CO #COFire URL	Other Useful Information
Next #HighParkFire RESIDENT briefing: 3pm McKee bldg at The Ranch in Loveland. @DenverChannel #Denver7	Other Useful Information
RT @NHLPA: RT @ryanobyrne84: My thoughts are with everyone in Colorado and hoping the fires come to an end. #PrayForColorado	Sympathy and support
Colorado fires sweep social media sites as readers look for info - Denver Post URL	Other Useful Information
#HighParkFire #OwlsNestProject Displaced families need basic, household items. URL @TMHRealEstate Please join our efforts	Donations and volunteering
RT @JHutcheon: Amazing RT @Metaldad555666: Amazing photo of just one of the bush fires burning in NSW, #Australia URL	Affected individuals
RT @dailybailey10: Minutes matter. Tomorrow be ready to leave early. Commissioners call to the fire threatened communities.  #SydneyFires	Caution and advice
@702sydney: Fire crews are checking car fuel tanks after a grassfire spread to the carpark of Sydney's Olympic Aquatic Centre #TooClose	Infrastructure and utilities
RT @smh: Fires burn in #Lithgow. Photo by the @lithgowmercury. #nswfires URL	Other Useful Information
These fires out in Colorado are crazy.	Other Useful Information
RT @babymonkey_25: üíûTHIS FIRE FIGHTER IN AUSTRALIA  IS GIVING A KOALA BEAR A DRINK OF WATER WHILE DURING A FIREüíû‚ô•OF GOLD... URL	Other Useful Information
RT @geoffstults: This is the Waldo Canyon fire in Colorado Springs and surrounding areas. Where my family lives. It's insane. URL ...	Other Useful Information
nydailynews: Thugs rob homes evacuated during devastating Colorado wildfire URL	Other Useful Information
#bushfires 'Significant' number of homes lost as 100 wildfires rage across Australian state (from @AP) #nswfires URL	Infrastructure and utilities
Fires in Sydney's Blue Mountains have destroyed nearly 200 homes. #nswfires URL	Infrastructure and utilities
RT @emilyrsutton: Praying for the people of Colorado Springs dealing with the worst wildfire in a decade. Here's a live stream: URL ...	Sympathy and support
RT @TripleM_NRL: Say again over. There's no time to leave. It's too late Mind blowing footage from the #nswfires frontline #heroes URL	Sympathy and support
One of the Colorado wildfires has burned an area greater than Seattle URL via @KIRO7Seattle	Other Useful Information
A couple hours outside of yellowstone and the skies are filled with smoke. Colorado fires? URL	Other Useful Information
Plz Flw @RedneckRag: Colorado fire claims first #victim, ranks as state's most... URL  #ColoradoSprings #firstvictim	Affected individuals
Just because the fire is starting to get under control in Colorado, doesn't mean we need to stop thinking about those people.	Sympathy and support
RT @BabyBash: Yeah I have lots of friends and fam in Colorado,, keep a blessing for them! Battling them big wild fires!! Many lost house ...	Sympathy and support
Keep the tens of thousands affected by the Colorado Wildfires in your hearts and minds. URL #COfires #Colorado Springs	Sympathy and support
I'm at Target. Can someone tell me what donations are needed for #HighParkFire evacuees and firefighters?	Donations and volunteering
RT @instagram: Frightening photo of the Colorado #wildfire by @dredayy66: URL Please stay safe!	Other Useful Information
RT @adam_wilkinson: Sydney fire 300km wide. Worst fire conditions in 40yrs. Katoomba preparing to evacuate &amp; state of emergency declared. S‚Ä¶	Caution and advice
@9NEWS: Incident command: NE &amp; SE corners, S flank of #HighParkFire are hot. East flank, which is closest to Ft Collins is calm	Other Useful Information
RT @ReutersUS: Firefighters gain upper hand on Colorado wildfires, gird for long season URL	Other Useful Information
Colorado wildfire now 50 percent contained URL #bay2biz	Other Useful Information
RT @dallasnewsphoto: See amazing photos of the Colorado wildfires by the Denver Post URL via @sharethis	Other Useful Information
RT @NationalPrayer: PRAYER ALERT: Remain in prayer for those fighting the #WaldoCanyonFire in Colorado Springs &amp; the 32,000+ people  ...	Sympathy and support
RT @NSWRFS: A picture tells 1000 words: Photos from the fire front and/or smoke plumes help us fight the fires email photos@rfs.nsw.gov.au ‚Ä¶	Affected individuals
FOLLOW AND RETWEET FOR RAIN FOR FRONT RANGE COLORADO AND THE SPRINGS PLEASE - GOD BLESS AND THANKS! -... URL	Sympathy and support
RT @rpy: ABC 702 reporting lit embers are falling on the water at Bondi #nswfires	Caution and advice
RT @AC360: #Breaking news tonight: 7,000 more people should evacuate immediately in #Colorado. Stay with #AC360 tonight.	Affected individuals
#highparkfire apparently now larger than the city of Boulder at approximately 31.25 sq miles	Other Useful Information
Update l Police Arrests    NSW Police have arrested a second boy, aged 15 over the #Heatherbrae Fire.	Affected individuals
RT @kevinltorres: 20,085 homes in Colorado Springs are threatened by the wildfire, according to CSFD.	Infrastructure and utilities
Pray for Colorado Springs.	Sympathy and support
Today my lifelong fear of our cabin in Colorado succumbing to fire has actually become a reality.	Affected individuals
My thoughts are with everyone affected by #nswbushfires and especially with the Rural Fire Service volunteers. Stay safe tomorrow #NSWRFS	Sympathy and support
Theres like 7 fires in colorado right now....	Other Useful Information
RT @anwyn: If you're wondering why NSW is freaking out right now, this is what our state looks like: each diamond is a fire URL	Other Useful Information
Waking up to the aftermath of the #nswfires, pollution, smoke and humidity in the air. Feels like Delhi! #toohottohandle	Affected individuals
Kudos to the volunteers &amp; emergency service personnel out there dealing with the #nswfires God bless you all and Godspeed for tomorrow x	Sympathy and support
Very tough fire day out there.  S'ly change about to hit Kiama. 90 mins to Sydney, 3-4 hours to Port Stephens. Good luck to RFS &amp; residents	Sympathy and support
RT @JenBrockie: If you're yet to head home, and get asthma, grab a puffer. #nswfires #bushfires	Other Useful Information
Spreading the word: From Pastor Joe Farrell at First Pres Church:  Gather in prayer for Colorado Springs at... URL	Sympathy and support
RT @Natalia_Cooper9: The Blue Mountains. So beautiful yet in a lot of danger today. Already so windy up here. @thetodayshow #nswfires URL	Other Useful Information
#nswfires  bargo NSW URL	Other Useful Information
RT @NSWRFS: Hall Rd: An Emergency Alert Telephone Message has been sent to people in the Wilton Area #NSWRFS #nswfires	Caution and advice
RT @KDVR: Follow the latest #HighParkFire updates with our live blog &amp; chat room URL #breakingnews #fortcollins	Affected individuals
Sydney fires will be known as the #greenoctoberfires thanks to @AdamBandt and fundamentalist party. #pmlive	Other Useful Information
#abcnews Live: RFS crews race to gain upper hand on NSW fires ahead of extreme conditions tomorrow via  URL	Other Useful Information
RT @therealmalcolm: Yo Australia send my prayers hope people are safe from the fires @MKTOAustralia	Sympathy and support
Colorado Springs Relief Update URL Thank you to everyone helping out in this difficult time.	Sympathy and support
Nexus 7, Euro 2012, Colorado fires, Colorado Springs, ... URL	Other Useful Information
RT @StyleEngine: Colorado Springs is burning, this gives you an idea of how bad the wild fire is... URL	Other Useful Information
Colorado Sees Record Fire Damage URL	Other Useful Information
Bush fires in the middle of October in Sydney is probably a great sign for the future of humans on this planet, right guys?	Other Useful Information
Sending my thoughts and prayers to all those involved in the #nswfires xx &lt;3	Sympathy and support
RT @DaRealAmberRose: My friend just sent me this pic from the mall in Colorado Springs smh so scary  URL	Other Useful Information
Linksview Rd #Springwood: Emergency Alert message sent to Winmalee &amp; Hawkesbury Heights area. Shelter as fire approaches. #NSWRSF #nswfires	Caution and advice
#NSWFIRES  #MEDOWIE #NSW  Residents in this areas are advised to #shelter_in_place as the #firefront approaches URL	Caution and advice
Live Streaming Video: Fire managers update #HighParkFire URL	Other Useful Information
RT @ReBourne_Again: Everyone please pray for our state of Colorado! There are 9 fires burning in our state! The most recent is The... h ...	Sympathy and support
RT @QldFire: Firies getting briefed before being deployed to assist at #nswfires URL	Other Useful Information
Prayers go out to Colorado Springs.	Sympathy and support
RT @NSWRFS: #NSWRFS Commissioner Shane Fitzsimmons: If we get through with less than 100 homes destroyed today, we have been lucky. #nswf‚Ä¶	Infrastructure and utilities
Where‚Äôs Waldo? According To Google Maps, Colorado Wildfire Burning Near Chicago URL via @sengineland	Other Useful Information
Officials warn an enormous blaze in southeastern Australia could merge with others to create a 'mega-fire' URL	Caution and advice
Lets all find a way to help those in need in #Colorado	Sympathy and support
#newsupdate Weather fear as Australia fires burn: More than 3,000 firefighters in Austral... URL #bbc #news #bbcupdat	Caution and advice
@nettynet67 @AdamBandt are you suggesting Tony is in Winmalee right now fighting fires? If not STFU #nswfires	Other Useful Information
#Evacuation center Cache La Poudre Middle School 3515 West County Road 54G in Laporte. #Colorado #Wildfire	Caution and advice
RT @larryemdur: Dear pathetic arseholes  looting houses in NSW fire zones .. You are disgusting pieces of shit !!!!	Sympathy and support
Woke up to the smell of smoke in Denver this morning. Thoughts are with those affected by #HighParkFire	Affected individuals
